가	과/JJ|감/NN|갑/VB|그/VB+어/EE|그/VB+아/EE|가/VB|갈/VB|갛/VB|가/NN
가논	그/VB+아/EE+놓/VB+ㄴ/EE
가놨	그/VB+어/EE+놓/VB+았/EE
가둔	그/VB+아/EE+두/VB+ㄴ/EE
가둘	그/VB+아/EE+두/VB+ㄹ/EE
가둬	그/VB+아/EE+두/VB+어/EE
가뒀	그/VB+아/EE+두/VB+었/EE
가라	갈/VB+아/EE
가려	그/VB+아/EE+리/VB+어/EE
가렸	그/VB+아/EE+리/VB+었/EE
가린	그/VB+아/EE+리/VB+ㄴ/EE
가본	그/VB+아/EE+보/VB+ㄴ/EE
가와	갑/VB+아/EE
가와여	갑/VB+아/EE+아/EE
가와졌	갑/VB+아/EE+지/VB+었/EE
가와해	갑/VB+아/EE+하/VB+아/EE
가와했	갑/VB+아/EE+하/VB+았/EE
가왔	갑/VB+았/EE
가우	갑/VB
가우마	갑/VB+으/EE+말/VB
가운	갑/VB+은/EE|갑/VB+ㄴ/EE
가울	갑/VB+ㄹ/EE|갑/VB+을/EE
가움	갑/VB+ㅁ/EE
가워	갑/VB+어/EE|갑/VB+아/EE
가워셨	갑/VB+어/EE+시/EE+었/EE
가워일	갑/VB+어/EE+이/VB+ㄹ/EE
가워져	갑/VB+어/EE+지/VB+어/EE
가워졌	갑/VB+어/EE+지/VB+었/EE
가워진	갑/VB+어/EE+지/VB+ㄴ/EE
가워질	갑/VB+어/EE+지/VB+ㄹ/EE
가워짐	갑/VB+어/EE+지/VB+ㅁ/EE
가워해	갑/VB+아/EE+하/VB+아/EE
가웠	갑/VB+었/EE
가졌	그/VB+아/EE+지/VB+었/EE
가한	기/NN+하/XV+ㄴ/EE
각	갑/NN
간	가/VB+ㄴ/EE|가/MA+ㄴ/JJ|갑/VB+ㄴ/EE|갈/VB+ㄴ/EE|가/NN+ㄴ/JJ|갛/VB+ㄴ/EE
간간	가/VB+ㄴ/EE+가/VB+ㄴ/EE
간게	가/VB+ㄴ/EE+것/NN+이/JJ
간단	가/VB+ㄴ/EE+다/EE
간댔	가/VB+ㄴ/EE+다/EE+하/VB+았/EE
간였	가/VB+ㄴ/EE+이/VB+었/EE
간온	가/VB+ㄴ/EE+오/VB+ㄴ/EE
간인	갛/VB+ㄴ/EE+이/VB+ㄴ/EE
간해	가/VB+ㄴ/EE+하/XV+아/EE
갈	가/NN+ㄹ/JJ|가/VB+ㄹ/EE
갈거요	가/VB+ㄹ/EE+것/NN+이/VB+오/EE
갈걸	가/VB+ㄹ/EE+것/NN+ㄹ/JJ
갈게	가/VB+ㄹ/EE+것/NN+이/JJ
갈긴	가/VB+ㄹ/EE+기/NN+이/VB+ㄴ/EE
갈낍	가/VB+ㄹ/EE+것/NN+이/VB+ㅂ/EE
갈라	가르/VB+아/EE
갈라렸	가르/VB+아/EE+리/VB+었/EE
갈라본	가르/VB+아/EE+보/VB+ㄴ/EE
갈라볼	가르/VB+아/EE+보/VB+ㄹ/EE
갈라져	가르/VB+아/EE+지/VB+어/EE
갈라졌	가르/VB+아/EE+지/VB+었/EE
갈라진	가르/VB+아/EE+지/VB+ㄴ/EE
갈라질	가르/VB+아/EE+지/VB+ㄹ/EE
갈랐	가르/VB+았/EE
갈러	가르/VB+어/EE
갈만	가/VB+ㄹ/EE
갈봐	가/VB+ㄹ/EE+보/VB+아/EE
갈순	가/VB+ㄹ/EE+수/NN+ㄴ/JJ
갈쳐	가르/VB+치/VB+어/EE|가/VB+ㄹ/EE+치/NN+이/VB+어/EE
갈칠	가르/VB+치/VB+ㄹ/EE
갈테	가/VB+ㄹ/EE+터/NN+이/VB
갈텐	가/VB+ㄹ/EE+터/NN+이/VB+ㄴ/EE
갈팅	가/VB+아/EE+ㄹ/EE+티/NN+이/VB+ᆼ/EE
갈한	가/VB+ㄹ/EE+하/XV+ㄴ/EE
감	가/JJ|아/EE+가/VB+ㅁ/EE|어/EE+가/VB+ㅁ/EE|가/VB+ㅁ/EE
감인	가/VB+ㅁ/EE+이/VB+ㄴ/EE
감한	가/VB+ㅁ/EE+하/VB+ㄴ/EE
갑	가/VB+ㅂ/EE|가/VB+ㅂ/EE+이/VB|가/EE+ㅂ/EE|가/NN+이/VB+ㅂ/EE
갑한	가/VB+ㅂ/EE+하/VB+ㄴ/EE
갓	가/VB+앗/EE|가/VB+ㅅ/EE|갖/MM
갓입	가/VB+앗/EE+이/VB+ㅂ/EE
갔	가/VB+았/EE
갔간	가/VB+았/EE+가/EE+ㄴ/JJ
갔게	가/VB+았/EE+ㄴ/EE+것/NN+이/JJ
갔난	가/VB+았/EE+나/EE+ㄴ/JJ
갔단	가/VB+았/EE+다/EE+ㄴ/JJ
갔댔	가/VB+았/EE+다/EE+하/VB+았/EE
갔마	가/VB+았/EE+말/VB+아/EE
갔봐	가/VB+았/EE+보/VB+아/EE
갔셨	가/VB+았/EE+시/EE+었/EE
갔온	가/VB+았/EE+오/VB+ㄴ/EE
갔올	가/VB+았/EE+오/VB+ㄹ/EE
갔와	가/VB+았/EE+오/VB+아/EE
갔완	가/VB+았/EE+오/VB+안/EE
갔왔	가/VB+았/EE+오/VB+았/EE
갔왔봐	가/VB+았/EE+오/VB+았/EE+보/VB+아/EE
갔왔음	가/VB+았/EE+오/VB+았/EE+으/EE+면/EE
갔으니	어/EE+가/VB+았/EE
갔인	가/VB+았/EE+이/VB+ㄴ/EE
갔잖	가/VB+았/EE+지/EE+않/VB
갔준	가/VB+았/EE+주/VB+ㄴ/EE
갔줬	가/VB+았/EE+주/VB+었/EE
갔지만	어/EE+가/VB+았/EE+지만/EE
갖	갓/MA|아/EE+가지/VB|가지/VB
개	갛/VB+아/EE|겋/VB+어/EE
개져	겋/VB+어/EE+지/VB+어/EE
개졌	겋/VB+어/EE+지/VB+었/EE
개진	겋/VB+어/EE+지/VB+ㄴ/EE
갠	개/VB+ㄴ/EE|개/NN+이/VB+ㄴ/EE|개/NN+ㄴ/JJ
갤	개/NN+ㄹ/JJ|개/VB+ㄹ/EE
갬	개/VB+ㅁ/EE
갰	개/VB+었/EE|갛/VB+았/EE|개/VB+았/EE
갼	갸/NN+ㄴ/JJ
걘	걔/NN+ㄴ/JJ
거	것/NN
거봄	그/VB+어/EE+보/VB+ㅁ/EE
거셨	걸/VB+시/EE+었/EE
거신	걸/VB+시/EE+ㄴ/EE
거요	것/NN+이/VB+오/EE
거우	겁/VB+으/EE|겁/VB
거우인	겁이/VB+ㄴ/EE
거운	겁/VB+은/EE|겁/VB+ㄴ/EE|겁/VB+ㄴ/JJ
거운내겐	겁/VB+ㄴ/EE+나/NN+에/JJ+게/JJ+ㄴ/JJ
거울	겁/VB+을/EE|겁/VB+ㄹ/EE
거울텐	겁/VB+을/EE+터/NN+이/VB+ㄴ/EE
거움	겁/VB+ㅁ/EE|겁/VB+음/EE
거움였	겁/VB+ㅁ/EE+었/EE
거움예	겁/VB+ㅁ/EE+에/EE
거움인	겁/VB+ㅁ/EE+이/VB+ㄴ/EE
거워	겁/VB+어/EE
거워셨	겁/VB+어/EE+시/EE+었/EE
거워옴	겁/VB+어/EE+오/VB+ㅁ/EE
거워일	겁/VB+어/EE+이/VB+ㄹ/EE
거워져	겁/VB+어/EE+지/VB+어/EE
거워져갔	겁/VB+어/EE+지/VB+어/EE+가/VB+았/EE
거워졌	겁/VB+어/EE+지/VB+었/EE
거워진	겁/VB+어/EE+지/VB+ㄴ/EE
거워질	겁/VB+어/EE+지/VB+ㄹ/EE
거워짐	겁/VB+어/EE+지/VB+ㅁ/EE
거워집	겁/VB+어/EE+지/VB+ㅂ/EE
거워한	겁/VB+어/EE+하/VB+ㄴ/EE
거워할	겁/VB+어/EE+하/VB+ㄹ/EE
거워했	겁/VB+어/EE+하/VB+았/EE
거웠	겁/VB+었/EE
거웠건	겁/VB+었/EE+것/NN+이/VB+ㄴ/EE
거져	긋/VB+어/EE+지/VB+어/EE
거진	어지/VB+ㄴ/EE
건	거/NN+이/VB+ㄴ/EE|것/NN+이/VB+ㄴ/EE|걸/VB+ㄴ/EE|것/NN+ㄴ/JJ|겋/VB+ㄴ/EE|겁/VB+ㄴ/EE
건린	것/NN+ㄴ/JJ+리/VB+ㄴ/EE
건봐	것/NN+이/VB+ㄴ/EE+보/VB+아/EE
건입	것/NN+ㄴ/JJ+이/VB+ㅂ/EE
건진	것/NN+이/VB+ㄴ/EE+지/EE+ㄴ/JJ|것/NN+이/VB+ㄴ/EE+지/NN+ㄴ/JJ
걷	걸/VB
걸	걷/VB+ㄹ/EE|것/NN+ㄹ/JJ
걸간	걷가/VB+ㄴ/EE
걸갈	걷가/VB+ㄹ/EE
걸갔	걷가/VB+았/EE
걸녀	걷니/VB+어/EE
걸녀본	걷니/VB+어/EE+보/VB+ㄴ/EE
걸녔	걷니/VB+었/EE
걸닌	걷니/VB+ㄴ/EE
걸닐	걷니/VB+ㄹ/EE
걸닒	걷니/VB+ㄹ/EE
걸러	거르/VB+어/EE+어/EE|거르/VB+어/EE
걸러낸	거르/VB+어/EE+내/VB+ㄴ/EE
걸러낼	거르/VB+어/EE+내/VB+ㄹ/EE
걸러냅	거르/VB+어/EE+내/VB+ㅂ/EE
걸러냈	거르/VB+어/EE+내/VB+었/EE
걸러라	거르/VB+어/EE+이/VB
걸러온	거르/VB+어/EE+오/VB+ㄴ/EE
걸러져	거르/VB+어/EE+지/VB+어/EE
걸러졌	거르/VB+어/EE+지/VB+었/EE
걸러진	거르/VB+어/EE+지/VB+ㄴ/EE
걸러질	거르/VB+어/EE+지/VB+ㄹ/EE
걸렀	거르/VB+었/EE
걸려	걷리/VB+어/EE
걸렸	걷/VB+아/EE+리/VB+었/EE
걸룬	것/NN+루/JJ+ㄴ/JJ
걸본	걷보/VB+ㄴ/EE
걸볼	걷보/VB+ㄹ/EE
걸봐	걷보/VB+아/EE|것/NN+ㄹ/JJ+보/VB+아/EE
걸셨	걷/VB+시/EE+었/EE
걸신	걷/VB+시/EE+ㄴ/EE
걸실	걷/VB+시/EE+시/EE+ㄹ/EE|걷/VB+시/EE+ㄹ/EE
걸십	걷/VB+시/EE+ㅂ/EE
걸였	걷이/VB+었/EE
걸온	걷오/VB+ㄴ/EE
걸올	걷오/VB+ㄹ/EE
걸올라	걷오/VB+르/VB+아/EE
걸올랐	걷오/VB+르/VB+았/EE
걸옵	걷오/VB+ㅂ/EE
걸와	걷오/VB+아/EE
걸왔	걷오/VB+았/EE
걸입	것/NN+ㄹ/JJ+이/VB+ㅂ/EE
걸준	거르/VB+주/VB+ㄴ/EE
걸줄	걷주/VB+ㄹ/EE
걸텐	것/NN+이/VB+ㄹ/EE+터/NN+이/VB+ㄴ/EE|거/NN+이/VB+ㄹ/EE+터/NN+이/VB+ㄴ/EE
걺	걸/VB+ㅁ/EE
검	겋/VB+ㅁ/EE|건/NN
겁	것/NN+ㅂ/EE|것/NN+이/VB+ㅂ/EE|ㄹ/EE+것/NN+이/VB+ㅂ/EE|거/NN+이/VB+ㅂ/EE
겁”	것/NN+이/VB+ㅂ/EE+"/SY
것	거/NN
겄	긋/VB+었/EE
겅	거/NN+이/VB+ᆼ/EE
게	기/VB+어/EE|거/NN+이/VB|기/NN+에/JJ|거/NN+이/JJ|것/NN+이/JJ
게게	것/NN+이/JJ+것/NN+이/JJ
게땐	것/NN+이/JJ+때/NN+ㄴ/JJ
게신	계시/VB+ㄴ/EE
게여	것/NN+이/VB+어/EE
게요	것/NN+이/VB+오/EE
게져	겋/VB+어/EE+지/VB+어/EE
게해	것/NN+이/JJ+하/XV+아/EE
겐	게/EE+이/VB+ㄴ/EE|게/EE+ㄴ/JJ|것/NN+이/VB+ㄴ/EE|게/JJ+이/VB+ㄴ/EE|게/JJ+ㄴ/JJ|게/MA+ㄴ/JJ
겔	게/NN+ㄹ/JJ|게/JJ+ㄹ/EE
겝	것/NN+이/VB+ㅂ/EE|것/NN+이/VB
겟	겄/EE|겠/EE
겠	겋/VB+었/EE|게/VB+었/EE
겨	것/NN+이/VB+어/EE|기/VB+어/EE
겨간	기/NN+어/EE+가/VB+ㄴ/EE|기/VB+어/EE+가/VB+ㄴ/EE
겨갈	기/NN+어/EE+가/VB+ㄹ/EE|기/VB+어/EE+가/VB+ㄹ/EE
겨감	기/VB+어/EE+가/VB+ㅁ/EE
겨갔	기/VB+어/EE+가/VB+았/EE
겨겼	기/VB+어/EE+기/VB+었/EE
겨겼잖	기/VB+어/EE+기/VB+었/EE+지/EE+않/VB
겨긴	기/VB+어/EE+기/EE+ㄴ/JJ
겨길	기/VB+어/EE+기/EE+ㄹ/JJ
겨날	기/VB+어/EE+나/VB+ㄹ/EE
겨났	기/VB+어/EE+나/VB+았/EE
겨낸	기/VB+어/EE+내/VB+ㄴ/EE|기/NN+어/EE+내/VB+ㄴ/EE
겨낼	기/NN+어/EE+내/VB+ㄹ/EE|기/VB+어/EE+내/VB+ㄹ/EE
겨냅	기/NN+어/EE+내/VB+ㅂ/EE
겨냈	기/VB+어/EE+내/VB+었/EE|기/NN+어/EE+내/VB+었/EE
겨녀	기/VB+어/EE+니/VB+어/EE
겨녔	기/VB+어/EE+니/VB+었/EE
겨논	기/VB+어/EE+놓/VB+ㄴ/EE
겨놀	기/VB+어/EE+놓/VB+ㄹ/EE
겨놔	기/VB+어/EE+놓/VB+아/EE
겨놨	기/VB+어/EE+놓/VB+았/EE
겨닌	기/VB+어/EE+니/VB+ㄴ/EE
겨닐	기/VB+어/EE+니/VB+ㄹ/EE
겨다	기/VB+어/EE+달/VB
겨댄	기/VB+어/EE+대/VB+ㄴ/EE
겨댔	기/VB+어/EE+대/VB+었/EE
겨둔	기/VB+어/EE+두/VB+ㄴ/EE
겨둘	기/VB+어/EE+두/VB+ㄹ/EE
겨둠	기/VB+어/EE+두/VB+ㅁ/EE
겨둬	기/VB+어/EE+두/VB+어/EE
겨둬얄	기/NN+어/EE+두/VB+어/EE+야/EE+하/VB+ㄹ/EE
겨뒀	기/VB+어/EE+두/VB+었/EE
겨뒀한	기/VB+어/EE+두/VB+었/EE+하/VB+ㄴ/EE
겨드	기/VB+어/EE+들/VB
겨든	기/VB+어/EE+들/VB+ㄴ/EE
겨려	기/VB+어/EE+리/VB+어/EE
겨렸	기/VB+어/EE+리/VB+었/EE|기/NN+어/EE+리/VB+었/EE
겨린	기/VB+어/EE+리/VB+ㄴ/EE
겨릴	기/VB+어/EE+리/VB+ㄹ/EE
겨림	기/VB+어/EE+리/VB+ㅁ/EE
겨본	기/VB+어/EE+보/VB+ㄴ/EE|기/VB+어/EE+아/EE+보/VB+ㄴ/EE
겨볼	기/VB+어/EE+보/VB+ㄹ/EE
겨봅	기/VB+어/EE+보/VB+ㅂ/EE
겨봐	기/VB+어/EE+보/VB+아/EE
겨봤	기/VB+어/EE+보/VB+았/EE
겨선	기/VB+어/EE+서/EE+ㄴ/JJ
겨설	기/VB+어/EE+서/EE+ㄹ/JJ
겨섰	기/VB+어/EE+서/VB+었/EE
겨세	기/VB+어/EE+시/EE+어/EE|기/NN+어/EE+시/EE+어/EE
겨셨	기/VB+어/EE+시/EE+었/EE
겨신	기/VB+어/EE+시/EE+ㄴ/EE
겨실	기/VB+어/EE+시/EE+ㄹ/EE
겨십	기/VB+어/EE+시/EE+ㅂ/EE
겨쓴	기/VB+어/EE+쓰/VB+ㄴ/EE
겨엔	기/VB+어/EE+에/JJ+는/JJ|기/VB+어/EE+에/JJ+ㄴ/JJ
겨여	기/VB+어/EE+아/EE|기/VB+어/EE+이/VB+어/EE
겨였	기/VB+어/EE+았/EE|기/VB+어/EE+이/VB+었/EE
겨예	기/VB+어/EE+이/VB+에/EE
겨온	기/NN+어/EE+오/VB+ㄴ/EE|기/VB+어/EE+오/VB+ㄴ/EE
겨올	기/VB+어/EE+오/VB+ㄹ/EE
겨올랐	기/VB+어/EE+오르/VB+았/EE
겨옴	기/VB+어/EE+오/VB+ㅁ/EE
겨와	기/VB+어/EE+오/VB+아/EE
겨왔	기/VB+어/EE+오/VB+았/EE|기/NN+어/EE+오/VB+았/EE
겨우	겹/VB+으/EE|겹/VB
겨우신	겹/VB+으/EE+시/EE+ㄴ/EE
겨운	겹/VB+ㄴ/EE|겹/VB+은/EE
겨울	겹/VB+을/EE|겹/VB+ㄹ/EE
겨움	겹/VB+음/EE|겹/VB+ㅁ/EE
겨워	겹/VB+어/EE+이/VB|겹/VB+어/EE
겨워여	겹/VB+어/EE+이/VB+어/EE
겨워졌	겹/VB+어/EE+지/VB+었/EE
겨워진	겹/VB+어/EE+지/VB+ㄴ/EE
겨워한	겹/VB+어/EE+하/VB+ㄴ/EE
겨워할	겹/VB+어/EE+하/VB+ㄹ/EE
겨워했	겹/VB+어/EE+하/VB+았/EE
겨웠	겹/VB+었/EE
겨인	기/VB+어/EE+이/VB+ㄴ/EE
겨일	기/VB+어/EE+이/VB+ㄹ/EE
겨져	기/VB+어/EE+지/VB+어/EE
겨져감	기/VB+어/EE+지/VB+어/EE+가/VB+ㅁ/EE
겨져를	기/VB+어/EE+지/VB+어/EE+르/VB+ㄹ/EE
겨져린	기/VB+어/EE+지/VB+어/EE+리/VB+ㄴ/EE
겨져본	기/VB+어/EE+지/VB+어/EE+보/VB+ㄴ/EE
겨져셔	기/VB+어/EE+지/VB+어/EE+서/EE
겨져온	기/VB+어/EE+지/VB+어/EE+오/VB+ㄴ/EE
겨져왔	기/VB+어/EE+지/VB+어/EE+오/VB+았/EE
겨졌	기/VB+어/EE+지/VB+었/EE|어/EE+지/VB+었/EE+기/EE
겨졌봐	기/VB+어/EE+지/VB+었/EE+보/VB+아/EE
겨준	기/VB+어/EE+주/VB+ㄴ/EE
겨줄	기/VB+어/EE+주/VB+ㄹ/EE
겨줌	기/VB+어/EE+주/VB+ㅁ/EE
겨줍	기/VB+어/EE+주/VB+ㅂ/EE
겨줘	기/VB+어/EE+주/VB+어/EE
겨줬	기/VB+어/EE+주/VB+었/EE
겨진	기/VB+어/EE+지/VB+ㄴ/EE|기/NN+어/EE+지/VB+ㄴ/EE
겨질	기/VB+어/EE+지/VB+ㄹ/EE|기/VB+어/EE+지/EE+ㄹ/JJ|기/VB+어/EE+ㄹ/EE+지/EE
겨짐	기/VB+어/EE+지/VB+ㅁ/EE
겨집	기/VB+어/EE+지/VB+ㅂ/EE
겨팬	기/VB+어/EE+패/VB+ㄴ/EE
겨팰	기/VB+어/EE+패/VB+ㄹ/EE
겨팼	기/VB+어/EE+패/VB+았/EE|기/VB+어/EE+패/VB+었/EE
겨픈	기/VB+어/EE+프/VB+ㄴ/EE
겨한	기/VB+어/EE+하/VB+ㄴ/EE
겨할	기/VB+어/EE+하/VB+ㄹ/EE
겨했	기/VB+어/EE+하/VB+았/EE
결	경/NN|겯/VB
겼	기/NN+었/EE|기/VB+었/EE
겼곤	기/VB+었/EE+고/EE+ㄴ/JJ
겼녔	기/VB+었/EE+니/VB+었/EE
겼세	기/VB+었/EE+시/EE+어/EE
겼였	기/VB+었/EE+이/VB+었/EE
겼잖	기/VB+었/EE+지/EE+않/VB
겼졌	기/VB+었/EE+지/VB+었/EE
겼텐	기/VB+었/EE+터/NN+이/VB+ㄴ/EE
곁	겉/NN
계	걔/NN+이/VB|제/NN
곈	계/NN+이/VB+ㄴ/EE
곌	계/NN+ㄹ/JJ
곕	계/NN+이/VB+ㅂ/EE
고	아/EE|교/NN|도/JJ|과/JJ|곱/VB|골/VB|구/NN|고/JJ|면/EE|는/JJ
고셨	골/VB+시/EE+었/EE
고십	골/VB+시/EE+ㅂ/EE
고와	곱/VB+아/EE|곱/VB+아/EE+이/VB
고와져	곱/VB+아/EE+지/VB+어/EE
고와졌	곱/VB+아/EE+지/VB+었/EE
고와진	곱/VB+아/EE+지/VB+ㄴ/EE
고와질	곱/VB+아/EE+지/VB+ㄹ/EE
고왔	곱/VB+았/EE
고우	곱/VB+으/EE+이/VB|곱/VB+으/EE|곱/VB
고우셨	곱/VB+시/EE+었/EE
고우신	곱/VB+으/EE+시/EE+ㄴ/EE
고운	곱/VB+ㄴ/EE
고울	곱/VB+ㄹ/EE
고움	곱/VB+ㅁ/EE
고은	곱/VB+ㄴ/EE
곤	고/EE+는/JJ|고/VB+ㄴ/EE|고/MA+ㄴ/JJ|골/VB+ㄴ/EE|고/JJ+ㄴ/JJ|고/EE+ㄴ/JJ|고/EE+는/EE|고/JJ+이/VB+ㄴ/EE|고/NN+이/VB+ㄴ/EE|고/EE+ㄴ/EE
골	고/NN+ㄹ/JJ|고르/VB
골라	고르/VB+아/EE+아/EE|고르/VB+아/EE+하/VB|고르/VB+아/EE|고르/VB+아/EE+어/EE
골라골라	고르/VB+아/EE+고르/VB+아/EE
골라릴	고르/VB+아/EE+리/VB+ㄹ/EE
골라볼	고르/VB+아/EE+보/VB+ㄹ/EE
골라봤	고르/VB+아/EE+보/VB+았/EE
골라세	고르/VB+아/EE+시/EE+어/EE
골라온	고르/VB+아/EE+오/VB+ㄴ/EE
골라왔	고르/VB+아/EE+오/VB+았/EE
골라일	고르/VB+아/EE+이/VB+ㄹ/EE
골라준	고르/VB+아/EE+주/VB+ㄴ/EE
골랐	고르/VB+았/EE
골러	고르/VB+어/EE
골러세	고르/VB+어/EE+시/EE+어/EE
곱	꼽/VB
공	고/NN
공할	고/NN+하/XV+ㄹ/EE
과	고/VB+아/EE
관	과/NN+이/VB+ㄴ/EE|과/JJ+ㄴ/JJ|과/NN+ㄴ/JJ
괍	과/NN+이/VB+ㅂ/EE
괸	괴/VB+ㄴ/EE
괼	괴/VB+ㄹ/EE
굅	괴/VB+ㅂ/EE
교	고/NN
굔	교/NN+ㄴ/JJ|교/NN+이/VB+ㄴ/EE
굘	교/NN+ㄹ/JJ
굡	교/NN+이/VB+ㅂ/EE
구	아/EE+굴/VB|굽/VB|꾸/VB|굴/VB
구셔	굴/VB+시/EE+어/EE
구와	굽/VB+아/EE
구우	굽/VB|굽/VB+으/EE
구운	굽/VB+ㄴ/EE|굽/VB+은/EE
구울	굽/VB+ㄹ/EE
구워	굽/VB+어/EE|굽/VB+어/EE+어/EE
구워낸	굽/VB+어/EE+내/VB+ㄴ/EE
구워냈	굽/VB+어/EE+내/VB+었/EE
구워렸	굽/VB+어/EE+리/VB+었/EE
구워릴	굽/VB+어/EE+리/VB+ㄹ/EE
구워왔	굽/VB+어/EE+오/VB+았/EE
구워져	굽/VB+어/EE+지/VB+어/EE
구워졌	굽/VB+어/EE+지/VB+었/EE
구워줄	굽/VB+어/EE+주/VB+ㄹ/EE
구워진	굽/VB+어/EE+지/VB+ㄴ/EE
구웠	굽/VB+었/EE
구진	굽지/VB+ㄴ/EE
군	구/EE+ㄴ/JJ|굽/VB+ㄴ/EE|구/VB+ㄴ/EE|굴/VB+ㄴ/EE|굽/VB+은/EE|구/NN+ㄴ/JJ|구/NN+이/VB+ㄴ/EE|구/NN+이/JJ+ㄴ/EE|구/JJ+ㄴ/JJ
군겐	구/NN+게/JJ+이/VB+ㄴ/EE
군대	구/NN+이/VB+ㄴ/EE+데/MA
군인	구/NN+이/VB+ㄴ/EE
굴	구/VB+ㄹ/EE|구/NN+이/VB+ㄹ/EE|구/NN+ㄹ/JJ
굴러	구르/VB+어/EE
굴러갔	구르/VB+어/EE+가/VB+았/EE
굴러려간	구르/VB+어/EE+리/VB+어/EE+가/VB+ㄴ/EE
굴러렸	구르/VB+어/EE+리/VB+었/EE
굴러릴	구르/VB+어/EE+리/VB+ㄹ/EE
굴러봐	구르/VB+어/EE+보/VB+아/EE
굴러온	구르/VB+어/EE+오/VB+ㄴ/EE
굴러와	구르/VB+어/EE+오/VB+아/EE
굴러왔	구르/VB+어/EE+오/VB+았/EE
굴러져	구르/VB+어/EE+지/VB+어/EE
굴러졌	구르/VB+어/EE+지/VB+었/EE
굴러진	구르/VB+어/EE+지/VB+ㄴ/EE
굴러질	구르/VB+어/EE+지/VB+ㄹ/EE
굴렀	구르/VB+었/EE
굴져렸	구르/VB+지/VB+어/EE+리/VB+었/EE
굻	굶/VB
굼	구/VB+ㅁ/EE
굽	굴/VB+ㅂ/EE|구/NN+이/VB+ㅂ/EE|구/NN+ㅂ/EE
궁	긍/NN
궈	그/VB+어/EE|굽/VB+어/EE|구/VB+어/EE+아/EE|구/VB+어/EE
궈낸	구/VB+어/EE+내/VB+ㄴ/EE
궈낼	구/VB+어/EE+내/VB+ㄹ/EE
궈냄	구/VB+어/EE+내/VB+ㅁ/EE
궈냈	구/VB+어/EE+내/VB+었/EE|구/VB+어/EE+내/VB+았/EE
궈둔	구/VB+어/EE+두/VB+ㄴ/EE
궈렸	그/VB+어/EE+리/VB+었/EE
궈온	구/VB+어/EE+오/VB+ㄴ/EE
궈왔	구/VB+어/EE+오/VB+았/EE
궈져	구/VB+어/EE+지/VB+어/EE
궈진	구/VB+어/EE+지/VB+ㄴ/EE
권	귀/VB+ㄴ/EE|굘/NN
궜	구/VB+었/EE|그/VB+었/EE
귄	귀/VB+ㄴ/EE|귀/NN+이/VB+ㄴ/EE|권/NN|귀/NN+ㄴ/JJ
귈	귀/VB+ㄹ/EE|귀/NN+이/VB+ㄹ/EE|귀/NN+ㄹ/JJ
귐	귀/VB+ㅁ/EE
규	기/VB+우/EE
그	긋/VB|글/VB|의/JJ|글이/VB
그간	긋가/VB+ㄴ/EE
그갔	긋가/VB+았/EE
그놨	긋놓/VB+았/EE
그댄	긋대/VB+ㄴ/EE
그댈	긋대/VB+ㄹ/EE
그둔	긋두/VB+ㄴ/EE
그둘	긋두/VB+ㄹ/EE
그러운	글/NN+럽/XV+ㄴ/EE
그렸	긋리/VB+었/EE
그셨	긋/VB+시/EE+었/EE
그시	긋/MA+이/MA
그왔	긋오/VB+았/EE
그은	긋/VB+을/EE+ㄴ/EE|긋/VB+ㄴ/EE
그져	긋지/VB+어/EE
그졌	긋지/VB+었/EE
그진	긋지/VB+ㄴ/EE
그짐	긋지/VB+ㅁ/EE
극	근/NN
근	글/VB+ㄹ/EE|글/VB+ㄴ/EE|글/MA+ㄴ/EE|그/VB+ㄴ/EE|긋/VB+ㄴ/EE
근인	글/VB+ㄴ/EE+이/VB+ㄴ/EE
글	그/VB+ㄹ/EE|긁/VB
글러	그르/VB+어/EE|그르/VB+어/EE+이/VB
글러린	그르/VB+어/EE+리/VB+ㄴ/EE
글렀	그르/VB+었/EE+이/VB|그르/VB+었/EE
금	그/VB+ㅁ/EE
급	근/NN|그/NN+이/VB+ㅂ/EE
긍	궁/NN
기	길/VB|끼/NN|지/JJ|것/NN+이/JJ|귀/NN|_/NN|것/NN+이/VB|지/VB
기어	겨/VB
기어났	겨나/VB+았/EE
기우	깁/VB
기우신	깁/VB+으/EE+시/EE+ㄴ/EE
기운	깁/VB+은/EE|깁/VB+ㄴ/EE
기움	깁/VB+ㅁ/EE
기워	깁/VB+어/EE
기워져	깁/VB+어/EE+지/VB+어/EE
기워진	깁/VB+어/EE+지/VB+ㄴ/EE
기웠	깁/VB+었/EE
기킨	시/XV+키/XV+ㄴ/EE
긴	기/NN+ㄴ/JJ|기/EE+ㄴ/JJ|것/NN+이/VB+ㄴ/EE|길/VB+ㄴ/EE|기/NN+이/VB+ㄴ/EE|기/VB+ㄴ/JJ|기/NA+ㄴ/EE|기/NN+ㄴ/EE|기/VB+ㄴ/EE|기/EE+ㄴ/EE|기/EE+이/VB+ㄴ/EE
긴린	길/VB+ㄴ/EE+리/VB+ㄴ/EE
긴림	길/VB+ㄴ/EE+리/VB+ㅁ/EE
긴여	기/VB+ㄴ/EE+아/EE
긴폄	길/VB+ㄴ/EE+펴/VB+ㅁ/EE
긴힘	길/VB+ㄴ/EE+히/VB+ㅁ/EE
길	기/EE+ㄹ/JJ|기/NN+ㄹ/JJ|기/VB+ㄹ/EE|긷/VB|기/EE+ㄹ/EE|기/VB+ㄹ/EE+이/VB|기/NN+ㄹ/EE|어/EE+기/EE+ㄹ/JJ|이/VB+기/EE+이/VB+ㄹ/EE|기/NN+이/VB+ㄹ/EE|아/EE+기/EE+ㄹ/JJ
길게	기/VB+ㄹ/EE+것/NN+이/JJ
길러	기르/VB+어/EE+아/EE|기르/VB+어/EE+하/VB|기르/VB+어/EE|기르/VB+어/EE+어/EE
길러간	기르/VB+어/EE+가/VB+ㄴ/EE
길러낸	기르/VB+어/EE+내/VB+ㄴ/EE
길러낼	기르/VB+어/EE+내/VB+ㄹ/EE
길러냈	기르/VB+어/EE+내/VB+었/EE
길러논	기르/VB+어/EE+놓/VB+ㄴ/EE
길러놨	기르/VB+어/EE+놓/VB+았/EE
길러본	기르/VB+어/EE+보/VB+ㄴ/EE
길러봐	기르/VB+어/EE+보/VB+아/EE
길러신	기르/VB+어/EE+시/EE+ㄴ/EE
길러온	기르/VB+어/EE+오/VB+ㄴ/EE
길러올	기르/VB+어/EE+오/VB+ㄹ/EE
길러왔	기르/VB+어/EE+오/VB+았/EE
길러져	기르/VB+어/EE+지/VB+어/EE
길러졌	기르/VB+어/EE+지/VB+었/EE
길러준	기르/VB+어/EE+주/VB+ㄴ/EE
길러줄	기르/VB+어/EE+주/VB+ㄹ/EE
길러줘	기르/VB+어/EE+주/VB+어/EE
길러진	기르/VB+어/EE+지/VB+ㄴ/EE
길러질	기르/VB+어/EE+지/VB+ㄹ/EE
길렀	기르/VB+었/EE|르/VB+었/EE+기/EE
길렸	긷리/VB+었/EE
길른	기르/VB+ㄴ/EE
길린	긷리/VB+ㄴ/EE
길봐	기/VB+ㄹ/EE+보/VB+아/EE
길온	긷오/VB+ㄴ/EE
길와	긷오/VB+아/EE
길카	기/NN+ㄹ/EE+고/EE+하/VB
길한	기/VB+ㄹ/EE+하/XV+ㄴ/EE|기/VB+ㄹ/EE+하/VB+ㄴ/EE
길할	기/NN+하/XV+ㄹ/EE
길했	기/NN+ㄹ/JJ+하/VB+았/EE
김	기/NN+ㅁ/EE|기/VB+ㅁ/EE+이/VB|기/VB+ㅁ/EE
김김	기/VB+ㅁ/EE+기/VB+ㅁ/EE
김한	기/VB+ㅁ/EE+하/XV+ㄴ/EE|기/VB+ㅁ/EE+하/VB+ㄴ/EE
김할	기/VB+ㅁ/EE+하/XV+ㄹ/EE
김함	기/VB+ㅁ/EE+하/XV+ㅁ/EE
깁	기/NN+이/VB+ㅂ/EE|기/EE+이/VB+ㅂ/EE|길/VB+ㅂ/EE|기/VB+ㅂ/EE|것/NN+ㅂ/EE|것/NN+이/VB+ㅂ/EE|기/NN+ㅂ/EE
깃	기/NN
깄	기/VB+었/EE|기/NN+있/VB
깄.	기/NN+있/VB
깅	기/NN+이/VB+ᆼ/NN
깆	기/VB+지/EE
까	가/JJ|깔/VB|끼/NN+아/JJ
까라	깔/VB+아/EE
까리	깔/NN+이/JJ
까와	깝/VB+어/EE|깝/VB+아/EE|깝/VB+어/EE+오/VB+아/EE
까와였	깝/VB+아/EE+이/VB+었/EE
까와왔	깝/VB+어/EE+오/VB+았/EE
까와져	깝/VB+어/EE+지/VB+어/EE
까와졌	깝/VB+아/EE+지/VB+었/EE|깝/VB+어/EE+오/VB+아/EE+지/VB+었/EE|깝/VB+어/EE+지/VB+었/EE
까와질	깝/VB+어/EE+지/VB+ㄹ/EE
까와짐	깝/VB+어/EE+오/VB+아/EE+지/VB+ㅁ/EE|깝/VB+어/EE+지/VB+ㅁ/EE
까왔	깝/VB+어/EE+오/VB+았/EE|깝/VB+았/EE
까우	깝/VB|깝/VB+으/EE|깝/VB+으/NN
까우세	깝/VB+시/EE+어/EE
까운	깝/VB+ㄴ/EE
까울	깝/VB+ㄹ/EE
까움	깝/VB+ㅁ/EE
까움인	깝/VB+ㅁ/EE+이/VB+ㄴ/EE
까워	깝/VB+어/EE+이/VB|깝/VB+어/EE
까워셨	깝/VB+어/EE+시/EE+었/EE
까워였	깝/VB+어/EE+이/VB+었/EE
까워온	깝/VB+어/EE+오/VB+ㄴ/EE
까워올	깝/VB+어/EE+오/VB+ㄹ/EE
까워져	깝/VB+어/EE+지/VB+어/EE
까워졌	깝/VB+어/EE+지/VB+었/EE
까워진	깝/VB+어/EE+지/VB+ㄴ/EE
까워질	깝/VB+어/EE+지/VB+ㄹ/EE
까워짐	깝/VB+어/EE+지/VB+ㅁ/EE
까워집	깝/VB+어/EE+지/VB+ㅂ/EE
까워한	깝/VB+어/EE+하/XV+ㄴ/EE
까워했	깝/VB+어/EE+하/VB+았/EE
까워헐	깝/VB+어/EE+허/VB+ㄹ/EE
까웠	깝/VB+었/EE
까웠랬	깝/VB+었/EE+라/EE+하/VB+았/EE
깍	깎/VB
깍낸	깎내/VB+ㄴ/EE
깎	깍/NN
깐	깔/VB+ㄴ/EE|까/MA+ㄴ/JJ|까/EE+ㄴ/JJ|까/NN+ㄴ/JJ|까/VB+ㄴ/EE|이/VB+까/EE+ㄴ/JJ
깔	가/VB+ㄹ/EE|까/VB+ㄹ/EE
깔건칠텐	까/VB+ㄹ/EE+거/NN+이/VB+ㄴ/EE+치/VB+ㄹ/EE+터/NN+이/VB+ㄴ/EE
깔려	낄리/VB+어/EE
깝	깔/VB+ㅂ/EE
깠	까/VB+았/EE
깠잖	까/VB+았/EE+지/EE+않/VB
깨	개/NN
깬	깨/VB+ㄴ/EE+이/VB|깨/VB+ㄴ/EE|깨/NN+이/VB+ㄴ/EE
깰	깨/VB+ㄹ/EE
깰할	깨/VB+ㄹ/EE+하/VB+ㄹ/EE
깸	깨/VB+ㅁ/EE
깹	깨/VB+ㅂ/EE
깼	깨/VB+었/EE
꺄	끼/NN+야/JJ|끼/NN+이/VB+야/EE|끼/NN+아/JJ
꺼	거/NN+이/VB|끄/VB|꺾/VB|끄/VB+어/EE|것/NN+이/VB
꺼렸	끄/VB+어/EE+리/VB+었/EE
꺼린	끄/VB+어/EE+리/VB+ㄴ/EE
꺼릴	끄/VB+어/EE+리/VB+ㄹ/EE
꺼봅	끄/VB+어/EE+보/VB+ㅂ/EE
꺼세	끄/VB+어/EE+시/EE+어/EE
꺼슈	껍/VB+시/EE
꺼우	껍/VB
꺼운	껍/VB+ㄴ/EE
꺼움	껍/VB+ㅁ/EE
꺼워	껍/VB+어/EE
꺼워져	껍/VB+어/EE+지/VB+어/EE
꺼워졌	껍/VB+어/EE+지/VB+었/EE
꺼워진	껍/VB+어/EE+지/VB+ㄴ/EE
꺼워질	껍/VB+어/EE+지/VB+ㄹ/EE
꺼웠	껍/VB+었/EE
꺼줄	끄/VB+어/EE+주/VB+ㄹ/EE
꺼진	끄/VB+어/EE+지/VB+ㄴ/EE
꺽	꺾/VB
껀	것/NN+ㄴ/JJ|꺼/NN+ㄴ/JJ|꺼/NN+이/VB+ㄴ/EE
껐	끄/VB+었/EE
껜	께/NN+이/VB+ㄴ/EE|께/NN+ㄴ/JJ|께/JJ+ㄴ/JJ
껭	겡/NN
껴	끼/VB+어/EE+이/VB|끼/VB|끼/VB+어/EE+아/EE|끼/VB+어/EE+하/VB|끼/VB+어/EE+어/EE|끼/VB+어/EE
껴갈	끼/VB+어/EE+가/VB+ㄹ/EE
껴겨	끼/VB+어/EE+기/VB+어/EE
껴긴	끼/VB+어/EE+기/EE+ㄴ/JJ
껴났	끼/VB+어/EE+나/VB+았/EE
껴낸	끼/VB+어/EE+내/VB+ㄴ/EE
껴논	끼/VB+어/EE+놓/VB+ㄴ/EE
껴놨	끼/VB+어/EE+어/EE+놓/VB+았/EE
껴둔	끼/VB+어/EE+두/VB+ㄴ/EE
껴렸	끄/VB+어/EE+리/VB+었/EE
껴린	끼/VB+어/EE+리/VB+ㄴ/EE
껴본	끼/VB+어/EE+보/VB+ㄴ/EE
껴볼	끼/VB+어/EE+보/VB+ㄹ/EE
껴봐	끼/VB+어/EE+보/VB+아/EE+하/VB|끼/VB+어/EE+보/VB+아/EE
껴봤	끼/VB+어/EE+보/VB+았/EE
껴선	끼/VB+어/EE+서/VB+ㄴ/EE
껴세	끼/VB+어/EE+시/EE+어/EE
껴셔	끼/VB+어/EE+시/EE+어/EE
껴신	끼/VB+어/EE+시/EE+ㄴ/EE
껴써	끼/VB+어/EE+쓰/VB+어/EE
껴썼	끼/VB+어/EE+쓰/VB+었/EE
껴여	끼/VB+어/EE+이/VB+어/EE
껴온	끼/VB+어/EE+오/VB+ㄴ/EE
껴왔	끼/VB+어/EE+오/VB+았/EE
껴인	끼/VB+어/EE+이/VB+ㄴ/EE
껴일	끼/VB+어/EE+이/VB+ㄹ/EE
껴져	끼/VB+어/EE+지/VB+어/EE|꺼지/VB+어/EE
껴져였	기/VB+어/EE+지/VB+어/EE+이/VB+었/EE
껴져온	끼/VB+어/EE+지/VB+어/EE+오/VB+ㄴ/EE
껴져왔	끼/VB+어/EE+지/VB+어/EE+오/VB+았/EE
껴졌	끼/VB+어/EE+지/VB+었/EE
껴준	끼/VB+어/EE+주/VB+ㄴ/EE
껴줄	끼/VB+어/EE+주/VB+ㄹ/EE
껴줌	끼/VB+어/EE+주/VB+ㅁ/EE
껴줬	끼/VB+어/EE+주/VB+었/EE
껴진	끼/VB+어/EE+지/EE+ㄴ/JJ|끼/VB+어/EE+지/VB+ㄴ/EE
껴질	끼/VB+어/EE+지/EE+ㄹ/JJ|끼/VB+어/EE+ㄹ/EE+지/EE|끼/VB+어/EE+지/VB+ㄹ/EE|끼/VB+어/EE+어/EE+지/VB+ㄹ/EE
껴짐	끼/VB+어/EE+지/VB+ㅁ/EE
껴집	끼/VB+어/EE+지/VB+ㅂ/EE
꼇	끼/VB+었/EE
꼈	끼/VB+었/EE
꼈잖	끼/VB+었/EE+지/EE+않/VB
꼈한	끼/VB+었/EE+하/XV+ㄴ/EE
꼐	께/JJ
꼬와	꼽/VB+아/EE
꼬운	꼽/VB+ㄴ/EE
꼬울	꼽/VB+ㄹ/EE
꼬움	꼽/VB+ㅁ/EE
꼬워	꼽/VB+어/EE
꼬워진	꼽/VB+어/EE+지/VB+ㄴ/EE
꼰	꼬/VB+ㄴ/EE
꼼	꼬/VB+ㅁ/EE
꽃	꽂/VB
꽤	꾀/MA
꽤해	꾀하/VB+아/EE
꾄	꾀/VB+ㄴ/EE
꾐	꾀/VB+ㅁ/EE
꾼	꾸/VB+ㄴ/EE
꿀	꾸/VB+ㄹ/EE
꿈	꾸/VB+ㅁ/EE
꿈했	꾸/VB+ㅁ/EE+하/XV+았/EE
꿉	꾸/VB+ㅂ/EE+이/VB|꾸/VB+ㅂ/EE
꿔	꾸/MA|꾸/VB+어/EE+이/VB|꾸/NN+어/EE|꾸/VB+어/EE+어/EE+하/VB|꾸/VB+어/EE+아/EE|꾸/VB+어/EE|꾸/VB+어/EE+하/VB|꾸/VB+어/EE+우/EE
꿔간	꾸/VB+어/EE+가/VB+ㄴ/EE
꿔갈	꾸/VB+어/EE+가/VB+ㄹ/EE
꿔갔	꾸/VB+어/EE+가/VB+았/EE
꿔길	꾸/VB+어/EE+기/EE+ㄹ/JJ
꿔냈	꾸/VB+어/EE+내/VB+었/EE
꿔논	꾸/VB+어/EE+놓/VB+은/EE|꾸/VB+어/EE+놓/VB+ㄴ/EE
꿔렸	꾸/VB+어/EE+리/VB+었/EE
꿔린	꾸/VB+어/EE+리/VB+ㄴ/EE
꿔릴	꾸/VB+어/EE+리/VB+ㄹ/EE
꿔본	꾸/VB+어/EE+보/VB+ㄴ/EE
꿔봐	꾸/VB+어/EE+보/VB+아/EE
꿔봤	꾸/VB+어/EE+보/VB+았/EE
꿔세	꾸/VB+어/EE+시/EE+어/EE
꿔셔	꾸/VB+어/EE+시/EE+어/EE
꿔실	꾸/VB+어/EE+시/EE+ㄹ/EE
꿔쓴	꾸/VB+어/EE+쓰/VB+ㄴ/EE
꿔온	꾸/VB+어/EE+오/VB+ㄴ/EE
꿔왔	꾸/VB+어/EE+오/VB+았/EE
꿔운	꾸/VB+어/EE+우/VB+ㄴ/EE
꿔져	꾸/VB+어/EE+지/VB+어/EE
꿔졌	꾸/VB+어/EE+었/EE+지/EE
꿔준	꾸/VB+어/EE+주/VB+ㄴ/EE
꿔줄	꾸/VB+어/EE+주/VB+ㄹ/EE
꿔줘	꾸/VB+어/EE+주/VB+어/EE
꿔줘봐	꾸/VB+어/EE+주/VB+어/EE+보/VB+아/EE
꿔줬	꾸/VB+어/EE+주/VB+었/EE
꿔진	꾸/VB+어/EE+지/VB+ㄴ/EE
꿔질	꾸/VB+어/EE+지/VB+ㄹ/EE
꿔짐	꾸/VB+어/EE+지/VB+ㅁ/EE
꿔침	꾸/VB+어/EE+치/VB+ㅁ/EE
꿔한	꾸/VB+어/EE+하/VB+ㄴ/EE
꿔할	꾸/VB+어/EE+하/VB+ㄹ/EE
꿔해	꾸/VB+어/EE+하/XV+아/EE
꿨	꾸/VB+었/EE+어/EE|꾸/VB+었/EE
꿴	꿰/VB+ㄴ/EE
꿸	꿰/VB+ㄹ/EE
뀄	꿰/VB+었/EE
뀐	뀌/VB+ㄴ/EE|뀌/VB+ㄴ/EE+에/JJ
뀐게	뀌/VB+ㄴ/EE+것/NN+이/JJ
뀔	뀌/VB+ㄹ/EE
뀜	뀌/VB+ㅁ/EE
뀝	뀌/VB+ㅂ/EE
뀠	뀌/VB+있/EE
끄	끌이/VB|끌/VB
끄게	끌/VB+것/NN+이/JJ
끄러	끌/VB+어/EE
끄셨	끌/VB+시/EE+었/EE
끈	끌/VB+ㄴ/EE|끄/VB+ㄴ/EE
끌	끄/VB+ㄹ/EE
끌러	끄르/VB+어/EE
끌러논	끄르/VB+어/EE+놓/VB+ㄴ/EE
끌렀	끄르/VB+었/EE
끌어	끄러/VB
끔	끌/VB+ㅁ/EE|금/MA|끄/VB+ㅁ/EE
끕	끌/VB+ㅂ/EE|끄/VB+ㅂ/EE
끼	것/NN+이/VB
끼어	껴/VB
낀	끼/NN+ㄴ/JJ|끼/NN+이/VB+ㄴ/EE|끼/VB+ㄴ/EE
낀인	끼/VB+ㄴ/EE+이/VB+ㄴ/EE
낄	끼/VB+ㄹ/EE|끼/NN+ㄹ/JJ
낄봐	끼/VB+ㄹ/EE+보/VB+아/EE
낄한	끼/VB+ㄹ/EE+하/XV+ㄴ/EE
낌	끼/VB+ㅁ/EE
낍	끼/VB+ㅂ/EE+이/VB|끼/NN+이/VB+ㅂ/EE|끼/VB+ㅂ/EE
낑	끼/NN+이/VB+ᆼ/EE
나	낳/VB+아/EE|낫/VB+아/EE|느/VB+아/EE
나갖	낳/VB+아/EE+가지/VB
나를	날르/VB+ㄹ/EE
나릴	낫리/VB+ㄹ/EE
나만	낫말/VB+ㄴ/EE
나볼	낳/VB+아/EE+보/VB+ㄹ/EE
나봐	알/VB+나/EE+보/VB
나셨	낫/VB+시/EE+었/EE
나신	낫/VB+시/EE+시/EE+ㄴ/EE|낳/VB+으/EE+시/EE+ㄴ/EE
나실	낫/VB+시/EE+ㄹ/EE
나에	내/VB
나와	납/VB+아/EE
나왔	납/VB+았/EE
나우	납/VB+으/EE|납/VB
나운	납/VB+ㄴ/EE|납/VB+은/EE
나울	납/VB+ㄹ/EE
나움	납/VB+ㅁ/EE
나워	납/VB+어/EE
나워져	납/VB+어/EE+지/VB+어/EE
나워졌	납/VB+어/EE+지/VB+었/EE
나워진	납/VB+어/EE+지/VB+ㄴ/EE
나웠	납/VB+었/EE
나은	낫/VB+ㄴ/EE
나을	낫/VB+ㄹ/EE+이/VB
나졌	낫/VB+었/EE+지/EE|낫지/VB+었/EE
나줘	놓아/VB+주/VB+어/EE
나진	낫지/VB+ㄴ/EE
난	나/VB+ㄴ/EE|날/VB+ㄴ/EE|나/NN+ㄴ/JJ|낳/VB+ㄴ/EE|납/VB+ㄴ/EE|낫/VB+ㄴ/EE|이/VB+나/EE+ㄴ/JJ|나/MA+ㄴ/JJ|나/NN+이/VB+ㄴ/EE
난’	나/VB+ㄴ/EE+'/SY
난”	나/VB+ㄴ/EE+"/SY
난게	나/VB+ㄴ/EE+것/NN+이/JJ
난엔	나/VB+ㄴ/EE+에/JJ+ㄴ/JJ
난여	나/VB+ㄴ/EE+아/EE
난였	나/VB+ㄴ/EE+았/EE
난해	나/VB+ㄴ/EE+하/VB+아/EE
날	나/VB+ㄹ/EE|낫/VB+ㄹ/EE|나/NN+ㄹ/JJ|나/NN+이/VB+ㄹ/EE|나/NN+를/JJ|나/VB|나/VB+ㄹ/EE+이/VB|낳/VB+ㄹ/EE
날거	나/VB+ㄹ/EE+것/NN+이/VB
날겁	나/VB+ㄹ/EE+것/NN+이/VB+ㅂ/EE
날껴	나/VB+ㄹ/EE+끼/EE+어/EE
날땐	나/VB+ㄹ/EE+때/NN+ㄴ/JJ
날라	나르/VB+아/EE|나르/VB+아/EE+아/EE+하/VB
날라갔	나르/VB+아/EE+가/VB+았/EE
날라려	나르/VB+아/EE+리/VB+어/EE
날라봤	나르/VB+아/EE+보/VB+았/EE
날라였	나르/VB+아/EE+이/VB+았/EE
날라온	나르/VB+아/EE+오/VB+ㄴ/EE
날라와	나르/VB+아/EE+오/VB+아/EE
날라왔	나르/VB+아/EE+오/VB+았/EE
날라져	나르/VB+아/EE+지/VB+어/EE
날라져온	나르/VB+아/EE+지/VB+어/EE+오/VB+ㄴ/EE
날라져왔	나르/VB+아/EE+지/VB+어/EE+오/VB+았/EE
날라준	나르/VB+아/EE+주/VB+ㄴ/EE
날랐	르/VB+았/EE+나/EE|나르/VB+았/EE
날러	나르/VB+어/EE
날봐	나/VB+ㄹ/EE+보/VB+아/EE
날한	나/VB+ㄹ/EE+ㄹ/EE+하/VB+ㄴ/EE|나/VB+ㄹ/EE+하/XV+ㄴ/EE
남	나/VB+ㅁ/EE
남인	나/VB+ㅁ/EE+이/VB+ㄴ/EE
남일	나/VB+ㅁ/EE+이/VB+ㄹ/EE
남일진	나/VB+ㅁ/EE+이/VB+ㄹ/EE+지/EE+이/VB+ㄴ/EE
남한	나/VB+ㅁ/EE+하/XV+ㄴ/EE
납	나/VB+ㅂ/EE+이/VB|아/EE+나/VB+ㅂ/EE|나/VB+ㅂ/EE|낳/VB+ㅂ/EE|나/NN+이/VB+ㅂ/EE
낫슴	나/VB+았/EE+습/EE
났	낫/VB+았/EE|낫/VB|나/VB+았/EE+이/VB|나/VB+았/EE
났구	나/VB+았/EE+고/EE
났랬	나/VB+았/EE+라/EE+하/VB+았/EE
났봐	나/VB+았/EE+보/VB+아/EE|았/EE+나/EE+보/VB+아/EE
났잖	나/VB+았/EE+지/EE+않/VB
났테	나/VB+았/EE+터/NN+이/VB
났텐	나/VB+았/EE+터/NN+이/VB+ㄴ/EE
났한	나/VB+았/EE+하/VB+ㄴ/EE
낭	나/VB+ᆼ/EE
낭한	냥/NN+하/XV+ㄴ/EE
내	나/NN+에/JJ|나/NN+이/VB|나/VB|나/NN+의/JJ
내거	나/NN+의/JJ+것/NN+이/VB
내게	나/NN+의/JJ+것/NN+이/JJ
내겐	나/NN+에/JJ+게/JJ+ㄴ/JJ
내겨	나/NN+에/JJ+기/VB+어/EE
내꺼	나/NN+의/JJ+것/NN+이/VB
내된	나/NN+의/JJ+되/XV+ㄴ/EE
내엔	나/NN+의/JJ+에/JJ+ㄴ/JJ
내였	나/NN+의/JJ+이/VB+었/EE
내인	나/NN+의/JJ+이/VB+ㄴ/EE
내일	나/NN+의/JJ+이/VB+ㄹ/EE
낸	내/VB+ㄴ/JJ|내/NN+ㄴ/JJ|내/VB+ㄴ/EE|내/VB+ㄴ/EE+이/VB|아/EE+내/VB+ㄴ/EE|어/EE+내/VB+ㄴ/EE|내/VB+ㄴ/EE+에/JJ|내/NN+이/VB+ㄴ/EE|내/VB+ㄴ/EE+./SY|내/MA+ㄴ/JJ|내/VB|나/NN+이/VB+ㄴ/EE
낸게	내/VB+ㄴ/EE+것/NN+이/JJ
낸낸	내/VB+ㄴ/EE+내/VB+ㄴ/EE
낸느	내/NN+는/JJ
낸만	내/VB+ㄴ/EE+말/VB+ㄴ/EE
낸였	내/VB+ㄴ/EE+았/EE
낸캐	내/VB+ㄴ/EE+카/VB+아/EE
낼	내/VB+ㄹ/EE|아/EE+내/VB+ㄹ/EE|내일/NN|내/NN+ㄹ/JJ|내/VB
낼겁	내/VB+ㄹ/EE+것/NN+이/VB+ㅂ/EE
낼렌	내일/NN+레/NN+이/VB+ㄴ/EE
낼봐	내/VB+ㄹ/EE+보/VB+아/EE
낼였	내/VB+ㄹ/EE+이/VB+었/EE
낼요	내/VB+ㄹ/EE+이/VB+오/EE
낼쳐	내/VB+ㄹ/EE+치/VB+어/EE
낼한	내/VB+ㄹ/EE+하/XV+ㄴ/EE
냄	내/VB+ㅁ/EE|나/VB+ㅁ/EE|내/VB+ㅁ/EE+이/VB
냄여	내/VB+ㅁ/EE+아/EE
냄일	내/VB+ㅁ/EE+이/VB+ㄹ/EE
냅	내/NN+이/VB+ㅂ/EE|내/VB+ㅂ/EE
냅둬	내버/VB+리/VB+어/EE+두/VB+어/EE
냇	내/VB+엇/EE
냈	내/VB+었/EE+이/VB|내/VB+었/EE|아/EE+내/VB+었/EE|내/VB+았/EE
냈간	내/VB+었/EE+가/EE+ㄴ/JJ
냈갑	내/VB+었/EE+가/EE+보/VB
냈고	내/VB+었/EE
냈다	내/VB+었/EE
냈봐	내/VB+었/EE+보/VB+아/EE
냈잖	내/VB+었/EE+지/EE+않/VB
냈텐	내/VB+었/EE+터/NN+이/VB+ㄴ/EE
냐	니/VB+아/EE|니/VB+어/EE|니/VB+야/EE
냔	냐/EE+ㄴ/EE|냐/EE+ㄴ/JJ|이/VB+냐/EE+ㄴ/JJ|냐/EE+는/EE
너	아/EE|느/VB+어/EE|널/VB|아/EE+아/EE
너린	느/VB+어/EE+리/VB+ㄴ/EE
너머	넘/VB+어/EE
넌	너/VB+ㄴ/EE|너/NN+ㄴ/JJ|널/VB+ㄴ/EE|는/EE|너/NN+이/VB+ㄴ/EE|년/NN
널	넣/VB+ㄹ/EE|너/NN+ㄹ/JJ|너/VB+ㄹ/EE
널러	너르/VB+어/EE
넒	널/VB+ㅁ/EE
넜	너/VB+었/EE
네	너/NN+의/JJ|너/NN+이/VB|너/NN+에/JJ
네겐	너/NN+에/JJ+게/JJ+ㄴ/JJ
네일	너/NN+의/JJ+이/VB+ㄹ/EE
네키	넷/NN+이/JJ
네한	제/NN+하/VB+ㄴ/EE
넨	네/NN+ㄴ/JJ|네/NN+ㄴ/EE|네/XN+ㄴ/JJ|네/VB+ㄴ/EE
넬	네/NN+ㄹ/JJ|네/XN+ㄹ/JJ|네/NN+이/VB+ㄹ/EE|네/VB+ㄹ/EE|네/XN+ㄹ/EE
넵	네/VB+ㅂ/EE
넸	네/VB+었/EE
녀	니/VB+어/EE|니/VB+어/EE+하/VB
녀간	니/VB+어/EE+가/VB+ㄴ/EE
녀갈	니/VB+어/EE+가/VB+ㄹ/EE
녀본	니/VB+어/EE+보/VB+ㄴ/EE
녀볼	니/VB+어/EE+보/VB+ㄹ/EE
녀봐	니/VB+어/EE+보/VB+아/EE
녀봤	니/VB+어/EE+보/VB+았/EE
녀선	니/VB+어/EE+서/EE+ㄴ/JJ|니/VB+어/EE+서/EE+이/VB+ㄴ/EE
녀셨	니/VB+어/EE+시/EE+었/EE
녀실	니/VB+어/EE+시/EE+ㄹ/EE
녀였	니/VB+어/EE+이/VB+었/EE
녀온	니/VB+어/EE+오/VB+ㄴ/EE
녀왔	니/VB+어/EE+오/VB+았/EE
녀진	니/VB+어/EE+지/EE+ㄴ/JJ
녀할	니/VB+어/EE+하/VB+ㄹ/EE
녁	녘/NN
녑	녀/NN+이/VB+ㅂ/EE
녔	니/VB+었/EE|어/EE+니/VB+었/EE
녔잖	니/VB+었/EE+지/EE+않/VB
녜	니/VB+에/EE+이/VB|니/VB+에/EE
노	놀이/VB|놀/VB|놓/VB+으/EE|놓/VB
노노	놀놀/VB
노라	놀/VB+아/EE
노무	놈/NN+우/JJ
노봐	놀보/VB+아/EE
노세	놓/VB+시/EE+어/EE
노셔	놀/VB+시/EE+어/EE
노셨	놀/VB+시/EE+었/EE
노신	놓/VB+으/EE+시/EE+ㄴ/EE
노십	놓/VB+으/EE+시/EE+ㅂ/EE
노피	높/MA+이/MA
논	놓/VB+ㄴ/EE|어/EE+놓/VB+ㄴ/EE|아/EE+놓/VB+ㄴ/EE|노/NN+이/VB+ㄴ/EE|놀/VB+ㄴ/EE|으놓/VB+은/EE
놀	노을/NN|놓/VB+ㄹ/EE
놂	놀/VB+ㅁ/EE
놉	놀/VB+ㅂ/EE
놔	놓/VB+아/EE+아/EE|놓아/VB|놓/VB+아/EE+이/VB|놓/VB+아/EE|어/EE+놓/VB+아/EE|놓/VB+아/EE+하/VB|누/VB+아/EE
놔도	놓아/VB+두/VB+어/EE
놔둔	놓/VB+아/EE+두/VB+ㄴ/EE
놔둘	놓/VB+아/EE+두/VB+ㄹ/EE
놔둬	놓/VB+아/EE+두/VB+어/EE|놓아/VB+두/VB+어/EE
놔뒀	놓/VB+아/EE+두/VB+었/EE
놔라	놓/VB+아/EE
놔렸	놓/VB+아/EE+리/VB+었/EE
놔봐	놓/VB+아/EE+보/VB+아/EE
놔봤	놓/VB+아/EE+보/VB+았/EE
놔부렀	놓/VB+아/EE+불/VB+었/EE
놔준	놓아/VB+주/VB+ㄴ/EE+이/VB|놓/VB+아/EE+주/VB+ㄴ/EE
놔줄	놓/VB+아/EE+주/VB+ㄹ/EE
놔줘	놓아/VB+주/VB+어/EE|놓/VB+아/EE+주/VB+어/EE
놔줬	놓/VB+아/EE+주/VB+었/EE
놨	어/EE+놓/VB+았/EE|놓/VB+았/EE|아/EE+놓/VB+았/EE|으놓/VB+았/EE
놨칠	놓/VB+았/EE+치/VB+ㄹ/EE
뇐	뇌/VB+ㄴ/EE
뇔	뇌/VB+ㄹ/EE
뇨	니/VB+오/EE+이/VB|니/VB+오/EE|니/EE+요/EE|니/EE+오/EE
누	눗/VB|눕/VB+우/EE|수/NN|눅/NN|눕/VB
누우	눕/VB+으/NN|눕/VB|눕/VB+으/EE
누우길	눕/VB+기/EE+ㄹ/JJ
누우셨	눕/VB+시/EE+었/EE
누우신	눕/VB+시/EE+ㄴ/EE
누운	눕/VB+은/EE|눕/VB+ㄴ/EE
누울	눕/VB+ㄹ/EE
누워	눕/VB+어/EE
누워렸	눕/VB+어/EE+리/VB+었/EE
누워린	눕/VB+어/EE+리/VB+ㄴ/EE
누워본	눕/VB+어/EE+보/VB+ㄴ/EE
누워셨	눕/VB+어/EE+시/VB+었/EE
누워신	눕/VB+어/EE+시/VB+ㄴ/EE
누워얀	눕/VB+어/EE+얗/VB+ㄴ/EE
누웠	눕/VB+었/EE|눕/VB+었/EE+이/VB
누은	눕/VB+ㄴ/EE
누음	눕/VB+ㅁ/EE
눈	는/EE|누/VB+ㄴ/EE
눌	누/VB+ㄹ/EE|눕/VB+ㄹ/EE|눋/VB|누르/VB
눌러	누르/VB+어/EE+ㄹ/EE|누르/VB+어/EE
눌러간	누르/VB+어/EE+가/VB+ㄴ/EE
눌러껐	누르/VB+어/EE+끄/VB+었/EE
눌러끈	누르/VB+어/EE+끄/VB+ㄴ/EE
눌러댄	누르/VB+어/EE+대/VB+ㄴ/EE
눌러댔	누르/VB+어/EE+대/VB+었/EE
눌러둬	누르/VB+어/EE+두/VB+어/EE
눌러렸	누르/VB+어/EE+리/VB+었/EE
눌러릴	누르/VB+어/EE+리/VB+ㄹ/EE
눌러립	누르/VB+어/EE+리/VB+ㅂ/EE
눌러본	누르/VB+어/EE+보/VB+ㄴ/EE
눌러봐세	누르/VB+어/EE+보/VB+아/EE+시/EE+어/EE
눌러사	누르/VB+어/EE+살/VB
눌러세	누르/VB+어/EE+시/EE+어/EE
눌러실	누르/VB+어/EE+시/EE+ㄹ/EE
눌러십	누르/VB+어/EE+시/EE+ㅂ/EE
눌러온	누르/VB+어/EE+오/VB+ㄴ/EE
눌러온게	누르/VB+어/EE+오/VB+ㄴ/EE+것/NN+이/JJ
눌러옴	누르/VB+어/EE+오/VB+ㅁ/EE
눌러왔	누르/VB+어/EE+오/VB+았/EE
눌러운	누르/VB+어/EE+우/VB+ㄴ/EE
눌러준	누르/VB+어/EE+주/VB+ㄴ/EE
눌러줄	누르/VB+어/EE+주/VB+ㄹ/EE
눌러진	누르/VB+어/EE+지/VB+ㄴ/EE
눌러할	누르/VB+어/EE+하/VB+ㄹ/EE
눌러합	누르/VB+어/EE+하/VB+ㅂ/EE
눌렀	누르/VB+었/EE
눌렀간	누르/VB+었/EE+가/EE+ㄴ/JJ
눔	누/VB+ㅁ/EE
눕	누/VB+ㅂ/EE|누/VB+ㅂ/EE+이/VB
눠	누/VB+어/EE+어/EE|눕/VB+어/EE|누/VB+어/EE
눠간	누/VB+어/EE+가/VB+ㄴ/EE
눠둔	누/VB+어/EE+두/VB+ㄴ/EE
눠렸	누/VB+어/EE+리/VB+었/EE
눠린	누/VB+어/EE+리/VB+ㄴ/EE
눠본	누/VB+어/EE+보/VB+ㄴ/EE
눠볼	누/VB+어/EE+보/VB+ㄹ/EE
눠세	누/VB+어/EE+시/EE+어/EE
눠신	누/VB+어/EE+시/EE+ㄴ/EE|누/VB+어/EE+시/VB+ㄴ/EE
눠십	누/VB+어/EE+시/EE+ㅂ/EE
눠썼	누/VB+어/EE+쓰/VB+었/EE
눠온	누/VB+어/EE+오/VB+ㄴ/EE
눠왔	누/VB+어/EE+오/VB+았/EE
눠져	누/VB+어/EE+지/VB+어/EE
눠졌	누/VB+어/EE+지/VB+었/EE
눠준	누/VB+어/EE+주/VB+ㄴ/EE
눠줄	누/VB+어/EE+주/VB+ㄹ/EE
눠줘	누/VB+어/EE+주/VB+어/EE
눠줬	누/VB+어/EE+주/VB+었/EE
눠쥔	누/VB+어/EE+쥐/VB+ㄴ/EE
눠진	누/VB+어/EE+지/VB+ㄴ/EE
눠질	누/VB+어/EE+지/VB+ㄹ/EE
눠짐	누/VB+어/EE+지/VB+ㅁ/EE
눴	누/VB+었/EE
뉘	누구/NN+의/JJ|누구/NN
뉘신	누구/NN+이/JJ+시/EE+ㄴ/EE
뉘십	누구/NN+이/JJ+시/EE+ㅂ/EE
뉘여졌	누이/VB+어/EE+지/VB+었/EE
뉜	뉘/VB+ㄴ/EE
뉠	뉘/VB+ㄹ/EE
뉨	뉘/VB+ㅁ/EE
뉩	뉘/VB+ㅂ/EE
뉴	니/VB+우/EE|니/VB+유/EE
늅	뉴/NN+이/VB+ㅂ/EE
느	늘/VB
느셨	늘/VB+시/EE+었/EE
는	아/EE|늘/VB|ㄴ/JJ|은/EE|ㄴ/EE|어/EE|늘/VB+ㄴ/EE|느/EE|은/JJ
니	너/NN+의/JJ|닐/VB
니실	닐/VB+시/EE+ㄹ/EE
닌	니/VB+ㄴ/EE|니/EE+ㄴ/EE|니/NN+이/VB+ㄴ/EE|닐/VB+ㄴ/EE|니/NN+ㄴ/JJ|니/VB+ㄴ/EE+이/VB|니/NN+ㄴ/EE
닌게	니/VB+것/NN+이/JJ|니/VB+ㄴ/EE+것/NN+이/JJ
닌난	니/VB+ㄴ/EE+나/VB+ㄴ/EE
닌배	니/VB+ㄴ/EE+보/VB+아/EE
닌봐	니/VB+ㄴ/EE+보/VB+아/EE
닌분	니/NN+이/VB+ㄴ/EE+부/VB+ㄴ/EE
닌여	니/VB+ㄴ/EE+아/EE
닌진	니/VB+ㄴ/EE+지/EE+ㄴ/JJ
닌한	니/VB+ㄴ/EE+하/XV+ㄴ/EE
닌해	니/VB+ㄴ/EE+하/VB+아/EE
닐	니/NN+ㄹ/JJ|니/NN+이/VB+ㄹ/EE|니/VB+ㄹ/EE+이/VB|니/VB+ㄹ/EE
닐가	니/VB+ㄹ/EE
닐내	니/VB+ㄹ/EE+나/NN+의/JJ
닐진	니/VB+ㄹ/EE+지/EE+이/VB+ㄴ/EE
닐테	니/VB+ㄹ/EE+터/NN+이/VB
닐텐	니/VB+ㄹ/EE+터/NN+이/VB+ㄴ/EE
닒	니/VB+ㄹ/EE
님	림/NN|니/VB+ㅁ/EE
님한	니/VB+ㅁ/EE+하/VB+ㄴ/EE
닙	니/VB+ㅂ/EE|니/VB+ㅂ/EE+이/VB
닝	니/VB+ᆼ/EE
다	타/NN|닿/VB|답/VB|달이/VB|이/VB+다/EE|어/EE+달/VB|달/VB
다마둬	담/VB+아/EE+두/VB+어/EE
다실	달/VB+시/EE+ㄹ/EE
다십	달/VB+시/EE+ㅂ/EE
다와	답/VB+아/EE
다와진	답/VB+아/EE+지/VB+ㄴ/EE|답/XV+아/EE+지/VB+ㄴ/EE
다왔	답/VB+았/EE|답/XV+았/EE
다우	달/VB+오/EE|답/XV+으/EE|답/VB|답/VB+으/EE
다우신	답/XV+시/EE+ㄴ/EE
다우십	답/VB+으/EE+시/EE+ㅂ/EE
다운	답/VB+ㄴ/EE|답/XV+ㄴ/EE|답/VB+ㄴ/EE+이/VB|답/VB+은/EE
다운거	답/XV+ㄴ/EE+것/NN+이/VB
다울	답/VB+ㄹ/EE|답/XV+ㄹ/EE|답/VB+을/EE
다움	답/XV+ㅁ/EE|답/XV+ㅁ/EE+,/SY|답/VB+ㅁ/EE+에/JJ+서/JJ|답/VB+ㅁ/EE+서/JJ+에/JJ|답/VB+ㅁ/EE
다움엔	답/VB+ㅁ/EE+에/JJ+ㄴ/JJ|답/VB+ㅁ/EE+에/JJ+서/JJ+에/JJ+ㄴ/JJ
다움인	답/VB+ㅁ/EE+에/JJ+서/JJ+이/VB+ㄴ/EE
다움일	답/VB+ㅁ/EE+이/VB+ㄹ/EE|답/VB+ㅁ/EE+에/JJ+서/JJ+이/VB+ㄹ/EE
다움함	답/VB+ㅁ/EE+하/XV+ㅁ/EE
다웁	답/XV+ㅂ/EE
다워	답/XV+아/EE|답/XV+어/EE|답/VB+어/EE
다워다와	답/VB+어/EE+답/VB+아/EE
다워져	답/VB+어/EE+지/VB+어/EE
다워졌	답/VB+어/EE+지/VB+었/EE
다워진	답/VB+어/EE+지/VB+ㄴ/EE|답/XV+어/EE+지/VB+ㄴ/EE
다워질	답/XV+어/EE+지/VB+ㄹ/EE|답/VB+어/EE+지/VB+ㄹ/EE
다워짐	답/XV+어/EE+지/VB+ㅁ/EE
다워한	답/XV+어/EE+하/VB+ㄴ/EE
다웠	답/VB+었/EE|답/XV+었/EE
다웠잖	답/VB+었/EE+지/EE+않/VB
다이	단/MA+히/MA
단	다/JJ+ㄴ/JJ|다/JJ+는/JJ|다/EE+ㄴ/JJ|다/EE+ㄴ/EE|달/VB+ㄴ/EE|다/MA+ㄴ/JJ|닿/VB+ㄴ/EE|다/NN+이/VB+ㄴ/EE|다/MA+이/VB+ㄴ/EE
단게	달/VB+ㄴ/EE+것/NN+이/JJ
단은	다/EE+는/EE
단인	달/VB+ㄴ/EE+이/VB+ㄴ/EE
달	다르/VB|닫이/VB|다/MA+이/VB+ㄹ/EE|다/EE+하/VB+ㄹ/EE|닫/VB|다/VB+ㄹ/EE|다/EE+이/VB+ㄹ/EE|다/NN+하/XV+ㄹ/EE|다/EE+ㄹ/EE|다/EE+고/EE+하/VB+ㄹ/EE|어/EE+다/EE+이/VB+ㄹ/EE|닫/VB+고/EE|닿/VB+ㄹ/EE
달간	닫가/VB+ㄴ/EE
달갈	닫가/VB+ㄹ/EE
달갔	닫가/VB+았/EE
달낸	닫내/VB+ㄴ/EE
달라	다르/VB+아/EE
달라였	다르/VB+아/EE+이/VB+었/EE
달라였봐	다르/VB+아/EE+이/VB+었/EE+보/VB+아/EE
달라일	다르/VB+아/EE+이/VB+ㄹ/EE
달랐	르/VB+았/EE+다/EE|다르/VB+았/EE
달려	달리/VB
달를	다르/VB+ㄹ/EE
달린	닫리/VB+ㄴ/EE
달셨	닫/VB+시/EE+었/EE
달신	닫/VB+시/EE+ㄴ/EE
달온	닫오/VB+ㄴ/EE
달왔	닫오/VB+았/EE
달입	닫이/VB+ㅂ/EE
달져	닫지/VB+어/EE
달졌	닫지/VB+었/EE
달줄	닫주/VB+ㄹ/EE
달진	닫지/VB+ㄴ/EE+이/VB|닫지/VB+ㄴ/EE
답	다/MA+이/VB+ㅂ/EE|다/EE+ㅂ/EE|다/MA+이/VB|다/NN+이/VB+ㅂ/EE|달/VB+ㅂ/EE
닸	다/NN+하/XV+았/EE
당	땅/MA|땅/NN
대	다/EE+하/VB+아/EE|다/NN|고/NN|내/VB|데/MA
댄	대/NN+이/VB+ㄴ/EE|아/EE+대/VB+ㄴ/EE|대/VB+ㄴ/EE|대/NN+ㄴ/EE|다/EE+하/VB+ㄴ/EE|어/EE+대/VB+ㄴ/EE
댈	아/EE+대/VB+ㄹ/EE|대/NN+ㄹ/JJ|대/VB+ㄹ/EE
댐	대/VB+ㅁ/EE
댑	대/NN+이/VB+ㅂ/EE|대/NN+입/VB|대/VB+ㅂ/EE
댔	다/EE+하/VB+았/EE|았/EE+다/EE+하/VB+았/EE|대/VB+았/EE|대/VB+었/EE+어/EE|아/EE+대/VB+었/EE|하/VB+았/EE|어/EE+대/VB+었/EE|대/VB+었/EE
댜	되/VB+야/EE
더	덜/VB
더우	덥/VB|덥/VB+으/EE
더운	덥/VB+은/EE|덥/VB+ㄴ/EE
더울	덥/VB+ㄹ/EE
더움	덥/VB+ㅁ/EE
더워	덥/VB+어/EE
더워감	덥/VB+어/EE+가/VB+ㅁ/EE
더워름	덥/VB+어/EE+르/VB+ㅁ/EE
더워였	덥/VB+어/EE+이/VB+었/EE
더워인	덥/VB+어/EE+이/VB+ㄴ/EE
더워져	덥/VB+어/EE+지/VB+어/EE
더워졌	덥/VB+어/EE+지/VB+었/EE
더워진	덥/VB+어/EE+지/VB+ㄴ/EE
더워질	덥/VB+어/EE+지/VB+ㄹ/EE
더웠	덥/VB+었/EE
던	덜/VB+ㄴ/EE|더/NN+이/VB+ㄴ/EE|더/NN+ㄴ/JJ
덞	덟/NN
덩	덜/MA
덯	떻/VB
데	게/EE|에/JJ|디/NN+에/JJ|대/MA|테/JJ|대/NN
덴	이/VB+ㄴ/EE+데/EE|데/NN+에/JJ+ㄴ/JJ|데/VB+ㄴ/EE|데/NN+ㄴ/JJ|데/NN+이/VB+ㄴ/EE
델	데/VB+ㄹ/EE|데/NN+ㄹ/JJ
델텐	데/NN+이/VB+ㄹ/EE+터/NN+이/VB+ㄴ/EE
뎁	데/NN+이/VB+ㅂ/EE
뎃	데/NN
뎌	디/VB+어/EE|디/VB+어/EE+어/EE|디/VB+어/EE+하/VB
뎌갔	디/VB+어/EE+가/VB+았/EE
뎌낸	디/VB+어/EE+내/VB+ㄴ/EE
뎌낼	디/VB+어/EE+내/VB+ㄹ/EE
뎌냄	디/VB+어/EE+내/VB+ㅁ/EE
뎌냈	디/VB+어/EE+내/VB+았/EE|디/VB+어/EE+내/VB+었/EE
뎌뎌	디/NN+이/VB+어/EE+디/NN+이/VB+어/EE
뎌본	디/VB+어/EE+보/VB+ㄴ/EE
뎌볼	디/VB+어/EE+보/VB+ㄹ/EE
뎌봅	디/VB+어/EE+보/VB+ㅂ/EE
뎌온	디/VB+어/EE+오/VB+ㄴ/EE
뎌왔	디/VB+어/EE+오/VB+았/EE
뎌져	디/VB+어/EE+지/VB+어/EE
뎌졌	디/VB+어/EE+지/VB+었/EE
뎌준	디/VB+어/EE+주/VB+ㄴ/EE
뎌줘	디/VB+어/EE+주/VB+어/EE
뎌진	디/VB+어/EE+지/VB+ㄴ/EE
뎌질	디/VB+어/EE+지/VB+ㄹ/EE|디/VB+어/EE+지/EE+ㄹ/JJ
뎌집	디/VB+어/EE+지/VB+ㅂ/EE
뎌한	디/VB+어/EE+하/VB+ㄴ/EE
뎌해	디/VB+어/EE+하/VB+아/EE
뎌했	디/VB+어/EE+하/VB+았/EE
뎠	디/VB+었/EE
뎠간	디/VB+었/EE+가/EE+ㄴ/JJ
도	아/EE+고/EE|독/NN|는/EE|돌/VB|두/VB+오/EE|고/EE|하/JJ+고/JJ|는/JJ|대/NN
도는	돌/VB+ㄴ/EE+이/VB
도와	돕/VB+아/EE+고/EE|돕/VB+어/EE|돕/VB+아/EE
도와다	돕/VB+아/EE+달/VB
도와려	돕/VB+아/EE+리/VB+어/EE
도와린	돕/VB+아/EE+리/VB+ㄴ/EE
도와릴	돕/VB+아/EE+리/VB+ㄹ/EE
도와줘	돕/VB+어/EE+주/VB+어/EE
도와할	돕/VB+아/EE+하/VB+ㄹ/EE
도왔	돕/VB+았/EE
도우	돕/VB|돕/VB+으/EE
도우셨	돕/VB+시/EE+었/EE
도우셨’	돕/VB+시/EE+었/EE+'/SY
도우실	돕/VB+시/EE+ㄹ/EE
도우심	돕/VB+시/EE+ㅁ/EE
도운	돕/VB+ㄴ/EE|돕/VB+은/EE
도울	돕/VB+ㄹ/EE
도움	돕/VB+ㅁ/EE
도웁	돕/VB|돕/VB+ㅂ/EE
독	록/EE
돈	돌/VB+ㄴ/EE+이/VB|도/NN+이/VB+ㄴ/EE|도/NN+ㄴ/JJ|돌/VB+ㄴ/EE
돌	도/JJ|도/NN+이/VB+ㄹ/EE
돌라줬	도르/VB+아/EE+주/VB+었/EE
돎	돌/VB+ㅁ/EE
돕	돌/VB+ㅂ/EE|도/NN+이/VB+ㅂ/EE
동	용/NN
돠	두/VB+아/EE
돼	되/VB+어/EE|되/XV+어/EE
돼간	되/VB+어/EE+가/VB+ㄴ/EE
돼갑	되/VB+어/EE+가/VB+ㅂ/EE
돼갔	되/VB+어/EE+가/VB+았/EE
돼긴	되/XV+어/EE+기/EE+ㄴ/JJ
돼놔	되/VB+어/EE+놓/VB+아/EE
돼렀	되/VB+어/EE+리/VB+었/EE
돼려	되/VB+어/EE+리/VB+어/EE
돼렸	되/XV+어/EE+리/VB+었/EE|되/VB+어/EE+리/VB+었/EE
돼린	되/VB+어/EE+리/VB+ㄴ/EE|되/XV+어/EE+리/VB+ㄴ/EE|되/VB+어/EE+리/VB+ㄴ/EE+이/VB
돼릴	되/VB+어/EE+리/VB+ㄹ/EE
돼봅	되/VB+어/EE+보/VB+ㅂ/EE
돼봐	되/XV+어/EE+보/VB+아/EE|되/VB+어/EE+보/VB+아/EE
돼뿠	되/XV+어/EE+뿌/VB+었/EE
돼선	되/VB+어/EE+서/EE+ㄴ/JJ|되/XV+어/EE+서/EE+ㄴ/JJ
돼세	되/VB+어/EE+시/EE+어/EE
돼였	되/VB+어/EE+이/VB+었/EE
돼온	되/VB+어/EE+오/VB+ㄴ/EE|되/XV+어/EE+오/VB+ㄴ/EE
돼왔	되/XV+어/EE+오/VB+았/EE|되/VB+어/EE+오/VB+았/EE
돼인	되/XV+어/EE+이/VB+ㄴ/EE
돼잖	되/VB+어/EE+지/EE+않/VB
돼준	되/VB+어/EE+주/VB+ㄴ/EE
돼줘	되/VB+어/EE+주/VB+어/EE
돼진	되/VB+어/EE+지/EE+ㄴ/JJ
돼질	되/VB+어/EE+지/EE+ㄹ/JJ
돼할	되/XV+어/EE+하/VB+ㄹ/EE
됐	되/VB+었/EE|되/XV+었/EE
됐긴	되/VB+었/EE+기/EE+ㄴ/JJ
됐길	되/VB+었/EE+기/EE+이/VB+ㄹ/EE
됐깐	되/XV+었/EE+까/EE+ㄴ/JJ
됐내	되/VB+었/EE+네/EE
됐봐	되/XV+었/EE+보/VB+아/EE|되/VB+었/EE+보/VB+아/EE
됐뵈	되/VB+었/EE+보/VB+아/EE
됐잖	되/VB+었/EE+지/EE+않/VB
됐한	되/VB+었/EE+하/VB+ㄴ/EE
됐해	되/XV+었/EE+하/VB+아/EE
됐했	되/XV+었/EE+하/VB+았/EE
된	되/VB+ㄴ/EE|되/XV+ㄴ/EE
된게	되/VB+ㄴ/EE+것/NN+이/JJ
된근	되/XV+ㄴ/EE+글/VB+ㄴ/EE
된댔	되/VB+ㄴ/EE+다/EE+고/EE+하/VB+았/EE
된인	되/XV+ㄴ/EE+이/VB+ㄴ/EE
된한	되/VB+ㄴ/EE+하/XV+ㄴ/EE|되/XV+ㄴ/EE+하/XV+ㄴ/EE
된함	되/XV+ㄴ/EE+하/VB+ㅁ/EE|되/VB+ㄴ/EE+하/VB+ㅁ/EE
된해	되/XV+ㄴ/EE+하/VB+아/EE|되/VB+ㄴ/EE+하/VB+아/EE
될	되/XV+ㄹ/EE|되/VB+ㄹ/EE
될거	되/VB+ㄹ/EE+것/NN+이/VB
될건	되/VB+ㄹ/EE+것/NN+이/VB+ㄴ/EE
될겁	되/VB+ㄹ/EE+것/NN+이/VB
될게	되/XV+ㄹ/EE+것/NN+이/JJ|되/VB+ㄹ/EE+것/NN+이/JJ|되/VB+ㄹ/EE+것/NN+이/VB
될봐	되/XV+ㄹ/EE+보/VB+아/EE|되/VB+ㄹ/EE+보/VB+아/EE
될봐였	되/VB+ㄹ/EE+보/VB+아/EE+이/VB+었/EE
될봐인	되/VB+ㄹ/EE+보/VB+아/EE+이/VB+ㄴ/EE
될십	되/VB+ㄹ/EE+싶/VB
될입	되/VB+ㄹ/EE+이/VB+ㅂ/EE
될직한	되/VB+ㄹ/EE+듯/NN+하/XV+ㄴ/EE
될진	되/VB+ㄹ/EE+지/EE+ㄴ/JJ
될테	되/VB+ㄹ/EE+터/NN+이/VB
될텐	되/XV+ㄹ/EE+터/NN+이/VB+ㄴ/EE|되/VB+ㄹ/EE+터/NN+이/VB+ㄴ/EE
될한	되/VB+ㄹ/EE+하/XV+ㄴ/EE|되/XV+ㄹ/EE+하/XV+ㄴ/EE|되/VB+ㄹ/EE+ㄹ/EE+하/VB+ㄴ/EE
될해	되/VB+ㄹ/EE+하/VB+아/EE
될했	되/VB+ㄹ/EE+ㄹ/EE+하/VB+았/EE
됨	되/VB+ㅁ/EE|되/XV+ㅁ/EE
됨인	되/VB+ㅁ/EE+이/VB+ㄴ/EE
됨임	되/XV+ㅁ/EE+이/VB+ㅁ/EE
됨한	되/VB+ㅁ/EE+하/XV+ㄴ/EE|되/XV+ㅁ/EE+하/VB+ㄴ/EE|되/VB+ㅁ/EE+하/VB+ㄴ/EE|되/XV+ㅁ/EE+하/XV+ㄴ/EE
됨할	되/VB+ㅁ/EE+하/VB+ㄹ/EE
됨해	되/VB+ㅁ/EE+하/VB+아/EE
됨했	되/VB+ㅁ/EE+하/XV+았/EE|되/XV+ㅁ/EE+하/VB+았/EE|되/VB+ㅁ/EE+하/VB+았/EE
됩	되/XV+ㅂ/EE|되/VB+ㅂ/EE+이/VB|되/VB+ㅂ/EE
됩한	되/XV+ㅂ/EE+하/VB+ㄴ/EE
됩해	되/VB+ㅂ/EE+하/VB+아/EE
됫음	되/VB+었/EE+습/EE
됬	되/VB+었/EE
됴코	둏/VB+고/EE
됴타	둏/VB+다/EE
두	둘/VB|둡/VB
두리	둘/NN+이/JJ
두신	둡/VB+으/EE+시/EE+ㄴ/EE
두우	둡/VB+으/EE|둡/VB
두우십	둡/VB+시/EE+ㅂ/EE
두운	둡/VB+ㄴ/EE|둡/VB+은/EE
두울	둡/VB+을/EE|둡/VB+ㄹ/EE
두움	둡/VB+ㅁ/EE
두워	둡/VB+어/EE
두워였	둡/VB+어/EE+이/VB+었/EE
두워왔	둡/VB+어/EE+오/VB+았/EE
두워인	둡/VB+어/EE+이/VB+ㄴ/EE
두워져	둡/VB+어/EE+지/VB+어/EE
두워져갔	둡/VB+어/EE+지/VB+어/EE+가/VB+았/EE
두워져린	둡지/VB+어/EE+리/VB+ㄴ/EE
두워졌	둡/VB+어/EE+지/VB+었/EE
두워진	둡/VB+어/EE+지/VB+ㄴ/EE
두워질	둡/VB+어/EE+지/VB+ㄹ/EE
두웠	둡/VB+었/EE
둔	두르/VB+ㄴ/EE|두/VB+ㄴ/EE+고/EE|두/NN+이/VB+ㄴ/EE|둡/VB+ㄴ/EE|어/EE+두/VB+ㄴ/EE|아/EE+두/VB+ㄴ/EE|두/VB+ㄴ/EE|두/VB+ㄴ/EE+이/VB|둠/NN|둘/VB+ㄴ/EE|으두/VB+ㄴ/EE
둔건	두/VB+ㄴ/EE+것/NN+은/JJ
둘	두/VB+ㄹ/EE|아/EE+두/VB+ㄹ/EE|두르/VB|두/NN+ㄹ/JJ
둘러	두르/VB+어/EE+이/VB|두르/VB+어/EE|두르/VB+어/EE+하/VB
둘러댈	두르/VB+어/EE+대/VB+ㄹ/EE
둘러댔	두르/VB+어/EE+대/VB+었/EE
둘러봐	두르/VB+어/EE+보/VB+아/EE
둘러선	두르/VB+어/EE+서/EE+ㄴ/JJ
둘러여	두르/VB+어/EE+어/EE
둘러온	두르/VB+어/EE+오/VB+ㄴ/EE
둘러왔	두르/VB+어/EE+오/VB+았/EE
둘러인	두르/VB+어/EE+이/VB+ㄴ/EE
둘러져	두르/VB+어/EE+지/VB+어/EE
둘러진	두르/VB+어/EE+지/VB+ㄴ/EE
둘렀	두르/VB+었/EE
둘렀간	두르/VB+었/EE+가/EE+ㄴ/JJ
둘봐	두/VB+ㄹ/EE+보/VB+아/EE
둘업	두/VB+ㄹ/EE+없/VB
둘인	들이/VB+ㄴ/EE
둘쳐	두/VB+ㄹ/EE+치/NN+이/VB+어/EE
둘테	두/VB+ㄹ/EE+터/NN+이/VB
둘했	두/VB+ㄹ/EE+하/XV+았/EE
둠	두/VB+ㅁ/EE
둠한	두/VB+ㅁ/EE+하/VB+ㄴ/EE
둡	두/VB+ㅂ/EE|아/EE+두/VB+ㅂ/EE
둥	등/NN
둬	둡/VB+어/EE|두/MM+어/MM|두/VB+어/EE|두/VB+어/EE+아/EE|아/EE+두/VB+어/EE|두/NN+어/EE|두어/VB|어/EE+두/EE|두/VB+어/EE+하/VB
둬간	두/VB+어/EE+가/VB+ㄴ/EE
둬갔	두/VB+어/EE+가/VB+았/EE
둬낼	두/VB+어/EE+내/VB+ㄹ/EE
둬놔	두/VB+어/EE+놓/VB+아/EE
둬둔	두/VB+어/EE+두/VB+ㄴ/EE
둬둘	두/VB+어/EE+두/VB+ㄹ/EE
둬려	두/VB+어/EE+리/VB+어/EE
둬렸	두/VB+어/EE+리/VB+었/EE
둬린	두/VB+어/EE+리/VB+ㄴ/EE
둬릴	두/VB+어/EE+리/VB+ㄹ/EE
둬본	두/VB+어/EE+보/VB+ㄴ/EE
둬볼	두/VB+어/EE+보/VB+ㄹ/EE
둬봐	두/VB+어/EE+보/VB+아/EE
둬선	두/VB+어/EE+서/EE+ㄴ/JJ
둬세	두/VB+어/EE+아/EE+시/EE+어/EE
둬셔	어/EE+두/VB+시/EE+어/EE
둬십	두/VB+어/EE+아/EE+시/EE+ㅂ/EE
둬온	두/VB+어/EE+오/VB+ㄴ/EE
뒀	으두/VB+었/EE|아/EE+두/VB+었/EE|두/VB+었/EE
뒀간	두/VB+었/EE+가/EE+ㄴ/JJ
뒀한	두/VB+었/EE+하/XV+ㄴ/EE
뒤덮였	이/VB+었/EE
뒬	뒤/NN+ㄹ/JJ
뒷	뒤/NN
드	들/VB|들/VB+이/JJ|어/EE+들/VB|들이/VB|도/NN|아/EE+들/VB
드게	들/VB+것/NN+이/JJ
드는	들/VB+ㄴ/EE
드러	들/VB+어/EE
드러진	들어/VB+지/VB+ㄴ/EE
드린	들이/VB+ㄴ/EE
드봐	들보/VB+아/EE
드세	들/VB+시/EE+어/EE
드셔	들/VB+시/EE+어/EE
드셔세	들/VB+시/EE+어/EE+시/EE+어/EE
드셨	들/VB+시/EE+었/EE|어/EE+들/VB+시/EE+었/EE
드셨텐	들/VB+시/EE+었/EE+터/NN+이/VB+ㄴ/EE
드신	들/VB+시/EE+ㄴ/EE
드실	들/VB+시/EE+ㄹ/EE
드십	들/VB+시/EE+ㅂ/EE
드했	들하/VB+았/EE
득	들/XN
든	들/VB|ㄴ/EE+들/EE|어/EE+들/VB+ㄴ/EE|들/VB+은/EE|들/VB+ㄴ/EE+이/VB|드/NN+이/VB+ㄴ/EE|들/VB+ㄴ/EE|들/VB+ㄴ/EE+에/JJ
든건	들/VB+ㄴ/EE+것/NN+이/VB+ㄴ/EE|들/VB+ㄴ/EE+거/NN+이/VB+ㄴ/EE
든게	들/VB+ㄴ/EE+것/NN+이/JJ
든단	들/VB+ㄴ/EE+다/EE+ㄴ/JJ
든입	들/VB+ㄴ/EE+이/VB+ㅂ/EE
듣	들/VB
들	듣/VB+시/EE|듣/VB|듣이/VB|듣/VB+ㄹ/EE|듣/VB+어/EE|듣하/VB
들겼	듣기/VB+었/EE
들긴	듣/VB+기/EE+ㄴ/JJ
들놔	듣놓/VB+아/EE
들달	듣/VB+다/EE+이/VB+ㄹ/EE
들댄	듣/VB+대/EE+ㄴ/JJ
들둘	듣두/VB+ㄹ/EE
들둬	듣두/VB+어/EE
들뒀	듣두/VB+었/EE
들려	듣/VB+어/EE
들린	듣리/VB+ㄴ/EE
들마	듣말/VB|듣말/VB+이/VB
들본	듣보/VB+ㄴ/EE
들볼	듣보/VB+ㄹ/EE
들볼진	듣보/VB+ㄹ/EE+지/EE+이/VB+ㄴ/EE
들봄	듣보/VB+ㅁ/EE
들봅	듣보/VB+ㅂ/EE
들봐	듣보/VB+아/EE+하/VB|듣보/VB+아/EE
들봐봐	듣보/VB+아/EE+보/VB+아/EE
들봤	듣보/VB+았/EE
들봤댔	듣보/VB+았/EE+다/EE+하/VB+았/EE
들봤한	듣보/VB+았/EE+ㄹ/EE+하/VB+ㄴ/EE
들섰세	듣/VB+시/EE+었/EE+시/EE+어/EE
들세	듣/VB+시/EE+어/EE
들셔	듣/VB+시/EE+어/EE
들셨	듣/VB+시/EE+었/EE
들슈	듣/VB+시/EE+유/EE
들신	듣/VB+시/EE+ㄴ/EE
들실	듣/VB+시/EE+ㄹ/EE
들십	듣/VB+시/EE+ㅂ/EE
들온	듣오/VB+ㄴ/EE
들왔	듣오/VB+았/EE
들인	듣이/VB+ㄴ/EE
들잖여	듣/VB+지/EE+않/VB+어/EE
들준	듣주/VB+ㄴ/EE
들줄	듣주/VB+ㄹ/EE
들줘	듣주/VB+어/EE
들진	듣/VB+지/EE+ㄴ/JJ
들질	듣/VB+지/EE+ㄹ/JJ
들한	듣/VB+하/XV+ㄴ/EE|듣하/VB+ㄴ/EE
들힐	듣히/VB+ㄹ/EE
듦	들/VB+ㅁ/EE
듬	들/VB|들/VB+ㅁ/EE
듭	들/VB+ㅂ/EE
듸	의/JJ
디	딪/VB|다/EE|이/VB
딘	디/NN+ㄴ/JJ|디/VB+ㄴ/EE|이/VB+ㄴ/EE+디/EE|디/NN+이/VB+ㄴ/EE
딘선	디/NN+이/VB+ㄴ/EE+서/JJ+ㄴ/JJ
딘엔	디/NN+이/VB+ㄴ/EE+에/JJ+ㄴ/JJ
딘엘	디/NN+이/VB+ㄴ/EE+에/JJ+ㄹ/JJ
딛	디/VB
딜	디/VB+ㄹ/EE|디/NN+ㄹ/JJ|디/NN+이/VB+ㄹ/EE|디/NN+ㄹ/JJ+아/EE|디/NN
딜한	디/VB+ㄹ/EE+하/XV+ㄴ/EE
딜했	디/VB+ㄹ/EE+하/VB+았/EE
딤	디/VB+ㅁ/EE
딥	디/NN+이/VB+ㅂ/EE|디/VB+ㅂ/EE
딧	디/NN+잇/VB
딨	디/NN+있/VB
딨세	디/NN+있/VB+시/EE+어/EE
따	디/NN+다/JJ|다/EE|뜨/VB+아/EE
따운	땁/VB+ㄴ/EE
따웠	땁/VB+았/EE
딴	따/MA+ㄴ/JJ|따/VB+ㄴ/EE
딸	따/VB+ㄹ/EE
땁	따/VB+ㅂ/EE
땄	따/VB+았/EE
때	떻/VB+어/EE+이/VB|떻/VB+어/EE
때...	떻/VB+어/EE+…/SY+…/SY
때’	떻/VB+어/EE+'/SY
때메	땜/NN+에/JJ
때질	떻/VB+어/EE+지/VB+ㄹ/EE
땐	때/NN+이/VB+ㄴ/EE|때/NN+는/JJ|때/VB+ㄴ/EE|때/NN+ㄴ/EE|때/NN+ㄴ/JJ
땐봐	때/NN+이/VB+ㄴ/EE+보/VB+아/EE
땔	때/NN+이/VB+ㄹ/EE|때/NN+ㄹ/JJ|때/VB+ㄹ/EE
땜	때/VB+ㅁ/EE
땜요	때문/NN+이/VB+오/EE
땝	때/NN+이/VB+ㅂ/EE
땠	떻/VB+었/EE|떻/VB+었/EE+이/VB|때/VB+았/EE|때/VB+었/EE
떠	떻/VB|떨/VB|뜨/VB+어/EE
떠놔	뜨/VB+어/EE+놓/VB+아/EE
떠는	뜨/VB+어/EE
떠려	뜨/VB+어/EE+리/VB+어/EE
떠려냈	뜨/VB+어/EE+리/VB+어/EE+내/VB+었/EE
떠려왔	뜨/VB+어/EE+리/VB+어/EE+오/VB+았/EE
떠렸	뜨/VB+어/EE+리/VB+었/EE
떠를	뜨/VB+어/EE+르/VB+ㄹ/EE
떠린	뜨/VB+어/EE+리/VB+ㄴ/JJ|뜨/VB+어/EE+리/VB+ㄴ/EE
떠릴	뜨/VB+어/EE+리/VB+ㄹ/EE
떠본	뜨/VB+어/EE+보/VB+ㄴ/EE
떠봐	뜨/VB+어/EE+보/VB+아/EE
떠봤	뜨/VB+어/EE+보/VB+았/EE
떠세	떻/VB+시/EE+어/EE
떠셨	떻/VB+시/EE+었/EE
떠신	떻/VB+시/EE+ㄴ/EE
떠실	떻/VB+시/EE+ㄹ/EE|떨/VB+시/EE+ㄹ/EE
떠십	떻/VB+시/EE+ㅂ/EE|떨/VB+시/EE+ㅂ/EE
떠였	떻이/VB+었/EE|뜨/VB+어/EE+이/VB+었/EE
떠온	뜨/VB+어/EE+오/VB+ㄴ/EE
떠올	뜨/VB+어/EE+오/VB+ㄹ/EE
떠올라	뜨/VB+어/EE+오르/VB+아/EE
떠와	뜨/VB+어/EE+오/VB+아/EE
떠운	떱/VB+ㄴ/EE
떠져	뜨/VB+어/EE+지/VB+어/EE
떠졌	뜨/VB+어/EE+지/VB+었/EE
떠준	뜨/VB+어/EE+주/VB+ㄴ/EE
떠줘	뜨/VB+어/EE+주/VB+어/EE
떠진	뜨/VB+어/EE+지/VB+ㄴ/EE
떠질	뜨/VB+어/EE+지/VB+ㄹ/EE|뜨/VB+어/EE+어/EE+지/VB+ㄹ/EE
떠하	떻/VB
떡	떻/VB+ᄀ/EE
떤	떻/VB|떨/VB+ㄴ/EE|떻/VB+ㄴ/EE|떨/VB+ㄴ/EE+이/VB|떻/VB+ㄴ/EE+이/VB
떤게	떨/VB+ㄴ/EE+것/NN+이/JJ
떨	떠/VB+ㄹ/EE|떻/VB+ㄹ/EE|떻/VB+ㄹ/EE+이/VB
떨진	떻/VB+ㄹ/EE+지/EE+ㄴ/JJ
떱	떨/VB+ㅂ/EE|떻/VB+ㅂ/EE
떳	뜨/VB+었/EE
떴	뜨/VB+었/EE
뗀	떼/VB+ㄴ/EE
뗄	떼/VB+ㄹ/EE
뗍	떼/VB+ㅂ/EE
뗐	떼/VB+었/EE
뗘	띠/VB+어/EE|뗳/VB+어/EE|떻/VB+어/EE
뗬	떼/VB+었/EE
뛴	뛰/NA+ㄴ/EE|뛰/VB+ㄴ/EE|뛰/VB+ㄴ/EE+이/VB
뛴잖	뛰/VB+ㄴ/EE+이/VB+지/EE+않/VB
뛸	뛰/VB+ㄹ/EE
뛸봐	뛰/VB+ㄹ/EE+보/VB+아/EE
뜀	뛰/VB+ㅁ/EE
뜁	뛰/VB+ㅂ/EE
뜨케	뀫/VB+게/EE
뜬	뜨/VB+ㄴ/EE
뜰	뜨/VB+ㄹ/EE
뜰가	뜨/VB+ㄹ/EE
뜸	뜨/VB+ㅁ/EE
뜹	뜨/VB+ㅂ/EE
띈	띄/VB+ㄴ/EE
띌	띄/VB+ㄹ/EE
띌봐	띄/VB+ㄹ/EE+보/VB+아/EE
띌한	띄/VB+ㄹ/EE+하/XV+ㄴ/EE
띕	띄/VB+ㅂ/EE
띠	신/NN
띤	띠/VB+ㄴ/EE
띨	띠/VB+ㄹ/EE
띰	띠/VB+ㅁ/EE
라	랗/VB|르/VB+아/EE|르/VB+어/EE
라간	르/VB+아/EE+가/VB+ㄴ/EE+이/VB|르/VB+아/EE+가/VB+ㄴ/EE
라갈	르/VB+아/EE+가/VB+ㄹ/EE
라갔	르/VB+아/EE+가/VB+았/EE
라낸	르/VB+아/EE+내/VB+ㄴ/EE
라녀	르/VB+아/EE+니/VB+어/EE
라를	르/VB+아/EE+르/VB+ㄹ/EE
라린	르/VB+아/EE+리/VB+ㄴ/EE
라볼	르/VB+아/EE+보/VB+ㄹ/EE
라불렀	르/VB+아/EE+부르/VB+었/EE
라선	르/VB+아/EE+서/EE+ㄴ/JJ
라섰	르/VB+아/EE+서/EE+었/EE
라세	르/VB+아/EE+시/EE+어/EE
라신댔	르/VB+아/EE+시/EE+다/EE+었/EE
라십	르/VB+아/EE+시/EE+ㅂ/EE
라여	르/VB+아/EE+이/VB+어/EE
라였	르/VB+아/EE+이/VB+었/EE|르/VB+아/EE+았/EE
라온	르/VB+아/EE+오/VB+ㄴ/EE|아/EE+오/VB+ㄴ/EE
라올	르/VB+아/EE+오/VB+ㄹ/EE
라올라갔	르/VB+아/EE+오르/VB+아/EE+가/VB+았/EE
라와	랍/VB+아/EE|르/VB+아/EE+오/VB+아/EE
라왔	랍/VB+았/EE|르/VB+아/EE+오/VB+았/EE
라우	랍/VB|랍/VB+으/EE
라우한	랍/VB+으/EE+하/XV+ㄴ/EE
라운	랍/VB+ㄴ/EE
라울	랍/VB+ㄹ/EE
라움	랍/VB+ㅁ/EE
라워	랍/VB+어/EE
라워한	랍/VB+어/EE+하/VB+ㄴ/EE
라웠	랍/VB+었/EE
라져	리/VB+어/EE+지/VB+어/EE|르/VB+아/EE+지/VB+어/EE
라준	르/VB+아/EE+주/VB+ㄴ/EE
라줄	르/VB+아/EE+주/VB+ㄹ/EE
라줘	르/VB+아/EE+주/VB+어/EE
라줬	르/VB+아/EE+주/VB+었/EE
라진	르/VB+아/EE+지/VB+ㄴ/EE
라질	르/VB+아/EE+지/EE+ㄹ/JJ
라한	르/VB+아/EE+하/VB+ㄴ/EE|람/NN+하/XV+ㄴ/EE
라할	르/VB+아/EE+하/VB+ㄹ/EE
라해	르/VB+아/EE+하/VB+아/EE
라해볼	르/VB+아/EE+하/VB+아/EE+보/VB+ㄹ/EE
라해봤	르/VB+아/EE+하/VB+아/EE+보/VB+았/EE
라했	르/VB+아/EE+하/VB+았/EE
란	이/VB+ㄴ/EE|라/NN+이/VB+ㄴ/EE|라/NN+ㄴ/JJ|ㄴ/JJ|이/VB+라/EE+는/EE|르/VB+아/EE+ㄴ/JJ|라/VB+ㄴ/EE+이/VB+라/EE|랗/VB+ㄴ/EE|라/EE+ㄴ/EE|라/VB+ㄴ/EE
랄	이/VB+라/EE+하/VB+ㄹ/EE|라/VB+ㄹ/EE|랗/VB+ㄹ/EE|라/EE+하/VB+ㄹ/EE|라/EE+ㄹ/EE|라/NN+ㄹ/JJ
랄게	라/VB+ㄹ/EE+거/NN+이/JJ
랄땐	라/VB+ㄹ/EE+때/NN+ㄴ/JJ
랄봐	라/VB+ㄹ/EE+보/VB+아/EE
랄질	라지/VB+ㄹ/EE
랄한	라/VB+ㄹ/EE+하/XV+ㄴ/EE
람	라/VB+ㅁ/EE
랍	라/VB+ㅂ/EE+이/VB|람/NN|라/VB+ㅂ/EE|라/EE+ㅂ/EE
랐	르/VB+았/EE|라/VB+았/EE|라/VB+았/EE+아/EE|어/EE+라/EE+하/VB+았/EE|라/VB+았/EE+./SY
랐봅	르/VB+았/EE+보/VB+ㅂ/EE
랐봐	라/VB+았/EE+보/VB+아/EE
랐옵	라/VB+았/EE+오/EE+ㅂ/EE
랐잖	라/VB+았/EE+지/EE+않/VB|르/VB+았/EE+지/EE+않/VB
랖	랍/NN
래	렇/VB+어/EE+이/VB|라/VB|렇/VB+어/EE|러/VB+어/EE+이/VB|렇/VB+어/EE+하/VB|러/VB+아/EE|랫/NN|리/MA+하/MA+여/MA|러/VB|랗/VB+어/EE|리하/VB+아/EE|렇/VB+아/EE|리/VB+아/EE|리/MA+하/XV+아/EE|라/VB+아/EE|러/VB+어/EE+어/EE|러/VB+어/EE+하/VB+아/EE|이/VB+라/EE|렇/VB+어/EE+어/EE|랜/NN|러/VB+어/EE|러/VB+어/EE+하/VB|랗/VB+아/EE|리/VB+어/EE|라/EE+하/VB+아/EE|라/VB+어/EE|라/EE
래놔	러/VB+어/EE+놓/VB+아/EE
래뒀	렇/VB+어/EE+두/VB+었/EE
래래	러/VB+어/EE+러/VB+어/EE
래볼	러/VB+어/EE+보/VB+ㄹ/EE
래봐	러/VB+어/EE+보/VB+아/EE|렇/VB+어/EE+보/VB+아/EE
래봤	러/VB+어/EE+보/VB+았/EE
래봬	렇/VB+어/EE+보이/VB+어/EE|렇/VB+어/EE+뵈/VB+어/EE
래선	렇/VB+어/EE+서/EE+ㄴ/JJ|렇/VB+어/EE+서/EE+이/VB+ㄴ/EE|러/VB+어/EE+서/EE+ㄴ/JJ|러/VB+어/EE+서/EE+이/VB+ㄴ/EE
래싼래	러/VB+어/EE+쌓러/VB+어/EE
래쌉	러/VB+어/EE+싸/VB+ㅂ/EE
래였	리/MA+하/XV+아/EE+이/VB+었/EE|렇/VB+어/EE+이/VB+었/EE|렇/VB+어/EE+았/EE
래온	러/VB+어/EE+오/VB+ㄴ/EE|렇/VB+어/EE+오/VB+ㄴ/EE
래왔	러/VB+어/EE+오/VB+았/EE
래인	렇/VB+어/EE+이/VB+ㄴ/EE|러/VB+어/EE+이/VB+ㄴ/EE
래일	러/VB+아/EE+이/VB+ㄹ/EE|렇/VB+어/EE+이/VB+ㄹ/EE
래졌	랗/VB+아/EE+지/VB+었/EE
래줘	러/VB+어/EE+주/VB+어/EE
래진	랗/VB+아/EE+지/VB+ㄴ/EE|렇/VB+어/EE+지/VB+ㄴ/EE|러/VB+어/EE+지/VB+ㄴ/EE
래질	렇/VB+어/EE+지/VB+ㄹ/EE
랜	란/EE|래/VB+ㄴ/EE|래/NN+이/VB+ㄴ/EE|래/NN+ㄴ/JJ
랠	래/NN+ㄹ/JJ|래/VB+ㄹ/EE
램	래/VB+ㅁ/EE
램일	람/NN+이/VB+ㄹ/EE|래/VB+ㅁ/EE+이/VB+ㄹ/EE
랩	래/VB+ㅂ/EE|래/NN+이/VB+ㅂ/EE|래/MA+이/VB+ㅂ/EE
랫	래/MA|래/NN|랜/NN
랬	래/VB+었/EE|렇/VB+었/EE|러/VB+았/EE|라/EE+고/EE+하/VB+았/EE|라/EE+았/EE|라/EE+었/EE|라/VB+었/EE|랗/VB+았/EE|러/VB+었/EE+이/VB|이/VB+라/EE+하/VB+았/EE|러/NN+하/XV+었/EE|아/EE+라/EE+하/VB+았/EE|러/VB+었/EE|래/EE+었/EE|라/EE+하/VB+었/EE|라/EE+하/VB+았/EE|래/VB+았/EE|라/VB+아/EE+었/EE
랬간	러/VB+었/EE+가/EE+ㄴ/JJ
랬댔	러/VB+었/EE+다/EE+하/VB+았/EE
랬랬	러/VB+었/EE+가/EE+러/VB+었/EE+가/EE
랬봐	러/VB+었/EE+보/VB+아/EE
랬에	러/VB+었/EE+어/EE
랬잖	러/VB+었/EE+지/EE+않/VB|렇/VB+었/EE+지/EE+않/VB|라/EE+하/VB+았/EE+지/EE+않/VB
략	랴/EE
러	아/EE|로/MA|리/VB+어/EE|렇/VB+어/EE|럽/VB|어/EE+서/EE|렇/VB|어/EE|럽/XV+어/EE|르/VB+어/EE+어/EE|르/VB+어/EE+하/VB|렇/MA|르/VB+어/EE|려/VB|르/VB+어/EE+아/EE|럽/VB+어/EE
러간	렇/VB+가/EE+ㄴ/JJ|렇가/VB+ㄴ/EE|리/VB+어/EE+가/VB+ㄴ/EE
러갈	르/VB+어/EE+가/VB+ㄹ/EE
러겼	르/VB+어/EE+어/EE+기/VB+었/EE
러낸	르/VB+어/EE+내/VB+ㄴ/EE
러낼	르/VB+어/EE+내/VB+ㄹ/EE
러냄	르/VB+어/EE+내/VB+ㅁ/EE
러냈	르/VB+어/EE+내/VB+었/EE
러댔	르/VB+어/EE+대/VB+었/EE
러든	리/VB+어/EE+들/VB+ㄴ/EE
러린	리/VB+어/EE+리/VB+ㄴ/EE|르/VB+어/EE+리/VB+ㄴ/EE
러맨	르/VB+어/EE+매/VB+ㄴ/EE
러바	럽/VB+아/EE
러버	럽/VB+어/EE
러본	르/VB+어/EE+보/VB+ㄴ/EE
러볼	르/VB+어/EE+보/VB+ㄹ/EE
러봄	르/VB+어/EE+보/VB+ㅁ/EE
러봐	럽/VB+아/EE|르/VB+어/EE+보/VB+아/EE
러선	어/EE+서/EE+ㄴ/JJ
러세	르/VB+어/EE+시/EE+어/EE|렇/VB+시/EE+어/EE
러셔	렇/VB+시/EE+어/EE
러셨	렇/VB+시/EE+었/EE
러스웠	럽/XV+았/EE
러실	렇/VB+시/EE+ㄹ/EE
러십	렇/VB+시/EE+ㅂ/EE|르/VB+어/EE+시/EE+ㅂ/EE
러였	어/EE+이/VB+었/EE|르/VB+어/EE+이/VB+었/EE
러온	르/VB+어/EE+오/VB+ㄴ/EE
러우	럽/XV|럽/VB|럽/VB+으/EE|럽/XV+으/EE
러우셔	럽/VB+으/EE+시/EE+어/EE
러우셨	럽/XV+으/EE+시/EE+었/EE
러우신	럽/VB+시/EE+ㄴ/EE
러운	럽/VB+은/EE|럽/XV+은/EE|럽/VB+ㄴ/EE|럽/XV+ㄴ/EE
러운게	럽/XV+ㄴ/EE+것/NN+이/JJ
러울	럽/XV+ㄹ/EE|럽/VB+ㄹ/EE|럽/VB+을/EE
러울봐	럽/VB+ㄹ/EE+보/VB+아/EE
러울테	럽/VB+ㄹ/EE+터/NN+이/VB
러움	럽/XV+ㅁ/EE|럽/VB+ㅁ/EE|럽/VB+음/EE|롭/VB+ㅁ/EE
러움엔	럽/XV+ㅁ/EE+에/JJ+ㄴ/JJ
러움인	럽/VB+음/EE+이/VB+ㄴ/EE|럽/XV+ㅁ/EE+이/VB+ㄴ/EE
러움일	럽/XV+ㅁ/EE+이/VB+ㄹ/EE|럽/VB+ㅁ/EE+이/VB+ㄹ/EE
러움함	럽/VB+ㅁ/EE+하/XV+ㅁ/EE
러워	럽/XV+어/EE|럽/VB+아/EE|럽/VB+어/EE+이/VB|럽/VB+어/EE
러워길	럽/XV+어/EE+기/EE+ㄹ/JJ
러워본	럽/XV+어/EE+보/VB+ㄴ/EE
러워셨	럽/VB+어/EE+시/EE+었/EE|럽/XV+어/EE+시/EE+었/EE
러워신	럽/VB+어/EE+시/EE+ㄴ/EE
러워였	럽/XV+어/EE+이/VB+었/EE|럽/XV+어/EE+았/EE|럽/VB+어/EE+이/VB+었/EE
러워인	럽/VB+어/EE+이/VB+ㄴ/EE
러워져	럽/VB+어/EE+지/VB+어/EE|럽/XV+어/EE+지/VB+어/EE
러워져갔	럽/XV+어/EE+지/VB+어/EE+가/VB+았/EE
러워졌	럽/VB+어/EE+지/VB+었/EE|럽/XV+어/EE+지/VB+었/EE
러워진	럽/XV+어/EE+지/VB+ㄴ/EE|럽/VB+어/EE+지/VB+ㄴ/EE
러워질	럽/VB+어/EE+ㄹ/EE+지/EE|럽/VB+어/EE+지/VB+ㄹ/EE|럽/XV+어/EE+지/VB+ㄹ/EE
러워짐	럽/XV+어/EE+지/VB+ㅁ/EE|럽/VB+어/EE+지/VB+ㅁ/EE
러워집	럽/VB+어/EE+지/VB+ㅂ/EE|럽/XV+어/EE+지/VB+ㅂ/EE
러워한	럽/XV+어/EE+하/VB+ㄴ/EE|럽/VB+어/EE+하/VB+ㄴ/EE
러워할	럽/XV+어/EE+하/VB+ㄹ/EE|럽/VB+어/EE+하/VB+ㄹ/EE
러워할봐	럽/XV+어/EE+하/VB+ㄹ/EE+보/VB+아/EE
러워합	럽/VB+어/EE+하/VB+ㅂ/EE
러워해	럽/VB+아/EE+하/VB+아/EE|럽/VB+어/EE+하/VB+아/EE|럽/XV+어/EE+하/VB+아/EE
러워해본	럽/VB+어/EE+하/VB+아/EE+보/VB+ㄴ/EE
러워했	럽/XV+어/EE+하/VB+았/EE|럽/VB+아/EE+하/VB+았/EE|럽/VB+어/EE+하/VB+았/EE
러웠	럽/VB+었/EE|럽/XV+었/EE|럽/XV+았/EE
러웠긴	럽/VB+었/EE+기/EE+ㄴ/JJ
러웠단	럽/XV+았/EE+다/JJ+ㄴ/JJ
러은	럽/XV+ㄴ/EE
러입	어/EE+이/VB+ㅂ/EE
러잖	렇/VB+지/EE+않/VB
러져	르/VB+어/EE+지/VB+어/EE
러져렸	리/VB+어/EE+지/VB+어/EE+리/VB+었/EE
러졌	르/VB+어/EE+지/VB+었/EE
러준	르/VB+어/EE+주/VB+ㄴ/EE
러줄	르/VB+어/EE+주/VB+ㄹ/EE
러줘	르/VB+어/EE+주/VB+어/EE
러진	르/VB+어/EE+지/VB+ㄴ/EE|럽/VB+어/EE+지/VB+ㄴ/EE|르/VB+어/EE+ㄴ/EE+지/EE|럽/XV+지/VB+ㄴ/EE|질러/VB+ㄴ/EE
러질	르/VB+어/EE+지/VB+ㄹ/EE
러케	렇/VB+게/EE
러할	르/VB+어/EE+하/VB+ㄹ/EE
러함	렇/VB+ㅁ/EE
런	럽/VB+ㄴ/EE|렇/VB+ㄴ/EE|렇/VB+게/EE|럽/XV+ㄴ/EE|러/NN+하/XV+ㄴ/EE|렇/VB+ㄴ/EE+이/VB|러/VB+ㄴ/EE|렇/VB+ㄴ/EE+에/JJ|럼/JJ
런걸	러/VB+ㄴ/EE+것/NN+ㄹ/JJ
런게	렇/VB+ㄴ/EE+것/NN+이/JJ|렇/VB+ㄴ/EE+거/NN+이/JJ|러/VB+ㄴ/EE+것/NN+이/JJ
런단	렇/VB+ㄴ/EE+다/EE+ㄴ/JJ
런댔	러/VB+ㄴ/EE+다/EE+하/VB+았/EE
런봅	렇/VB+ㄴ/EE+보/VB+ㅂ/EE
런봐	렇/VB+ㄴ/EE+보/VB+아/EE|러/VB+ㄴ/EE+보/VB+아/EE
런였	렇/VB+ㄴ/EE+이/VB+었/EE
런요	렇/VB+ㄴ/EE+이/VB+오/EE
런인	럽/XV+ㄴ/EE+이/VB+ㄴ/EE
런잖	러/VB+ㄴ/EE+지/EE+않/VB
런진	렇/VB+ㄴ/EE+지/EE+는/JJ
럴	렇/VB+ㄹ/EE|럽/VB+ㄹ/EE|러/VB+ㄹ/EE+이/VB|러/VB+ㄹ/EE|럽/XV+ㄹ/EE|렇/VB+ㄹ/EE+이/VB
럴게	렇/VB+ㄹ/EE+것/NN+이/VB
럴봐	러/VB+ㄹ/EE+보/VB+아/EE
럴순	러/VB+ㄹ/EE+수/NN+ㄴ/JJ
럴엔	렇/VB+ㄹ/EE+에/JJ+ㄴ/JJ
럴였	러/VB+ㄹ/EE+았/EE
럴잖	러/VB+ㄹ/EE+지/EE+않/VB
럴진	렇/VB+ㄹ/EE+지/EE+이/VB+ㄴ/EE|렇/VB+ㄹ/EE+지/EE+ㄴ/JJ|러/VB+ㄹ/EE+지/EE+이/VB+ㄴ/EE
럴테	러/VB+ㄹ/EE+터/NN+이/VB
럴한	러/VB+ㄹ/EE+하/XV+ㄴ/EE|렇/VB+ㄹ/EE+하/XV+ㄴ/EE|렇/VB+ㄴ/EE+하/XV+ㄴ/EE
럴할	렇/VB+ㄹ/EE+하/XV+ㄹ/EE
럴합	렇/VB+ㄹ/EE+하/XV+ㅂ/EE
럴해	러/VB+ㄹ/EE+하/XV+아/EE|렇/VB+ㄹ/EE+하/XV+아/EE
럴했	렇/VB+ㄹ/EE+하/XV+았/EE
럴헌	렇/VB+ㄹ/EE+허/XV+ㄴ/EE
럼	럽/VB+ㅁ/EE|러/VB+ㅁ/EE|럽/XV+ㅁ/EE|렇/VB+ㅁ/EE|러/VB+면/EE|러/MA+면/MA
럼한	렇/VB+ㅁ/EE+하/XV+ㄴ/EE
럽	러/VB+ㅂ/EE|렇/VB+ㅂ/EE|롭/VB|법/NN
럽혀진	렵히/VB+어/EE+지/VB+ㄴ/EE
럿	르/VB+엇/EE
렀	르/VB+었/EE|럽/XV+었/EE|었/EE|아/EE+리/VB+었/EE|리/VB+었/EE
렀인	었/EE+이/VB+ㄴ/EE
렁	러/VB+ᆼ/EE
렇	러/VB|러/IC
레	렇/VB+어/EE|럽/XV+게/EE|네/EE|례/NN|렌/NN|러/VB+어/EE
레선	러/VB+어/EE+서/EE+ㄴ/JJ
렌	레/NN+이/VB+ㄴ/EE|레/NN+ㄴ/EE|레/NN+ㄴ/JJ|레/VB+ㄴ/EE
렐	레/VB+ㄹ/EE
렘	레/VB+ㅁ/EE
렜	레/VB+었/EE|러/VB+었/EE
렜잖	러/VB+었/EE+지/EE+않/VB
려	리/VB+어/EE|르/VB+어/EE
려간	리/VB+어/EE+어/EE+가/VB+ㄴ/EE|리/VB+어/EE+가/VB+ㄴ/EE
려갈	리/VB+어/EE+가/VB+ㄹ/EE
려갈텐	리/VB+어/EE+가/VB+ㄹ/EE+터/NN+이/VB+ㄴ/EE
려감	리/VB+어/EE+가/VB+ㅁ/EE
려갔	리/VB+어/EE+가/VB+았/EE
려겼	리/VB+어/EE+기/VB+었/EE
려곤	리/VB+어/EE+고/EE+는/EE
려긴	리/VB+어/EE+기/EE+ㄴ/JJ
려길	리/VB+어/EE+기/EE+ㄹ/JJ
려난	리/VB+어/EE+나/VB+ㄴ/EE
려날	리/VB+어/EE+나/VB+ㄹ/EE
려났	리/VB+어/EE+나/VB+았/EE
려낸	리/VB+어/EE+내/VB+ㄴ/EE
려낼	리/VB+어/EE+내/VB+ㄹ/EE
려냄	리/VB+어/EE+내/VB+ㅁ/EE
려냅	리/VB+어/EE+내/VB+ㅂ/EE
려냈	리/VB+어/EE+내/VB+었/EE
려너	리/VB+어/EE+아/EE
려녀	리/VB+어/EE+니/VB+어/EE
려녀봤	리/VB+어/EE+니/VB+어/EE+보/VB+았/EE
려녀선	리/VB+어/EE+니/VB+어/EE+서/EE+ㄴ/JJ
려녔	리/VB+어/EE+니/VB+었/EE
려노	리/VB+어/EE+놓/VB+으/EE
려논	리/VB+어/EE+놓/VB+ㄴ/EE
려놀팅	리/VB+어/EE+놓/VB+ㄹ/EE+티/NN+이/VB+ᆼ/EE
려놔	리/VB+어/EE+놓/VB+아/EE
려놨	리/VB+어/EE+놓/VB+았/EE
려닌	리/VB+어/EE+니/VB+ㄴ/EE
려닐	리/VB+어/EE+니/VB+ㄹ/EE
려다	리/VB+어/EE+달/VB
려달	리/VB+어/EE+다/EE+이/VB+ㄹ/EE
려댄	리/VB+어/EE+대/VB+ㄴ/EE
려댈	리/VB+어/EE+대/VB+ㄹ/EE
려댔	리/VB+어/EE+대/VB+었/EE
려되	리/VB+어/EE+도/EE
려둔	리/VB+어/EE+두/VB+ㄴ/EE
려둘	리/VB+어/EE+두/VB+ㄹ/EE
려둠	리/VB+어/EE+두/VB+ㅁ/EE
려둬	리/VB+어/EE+두/VB+어/EE|리/VB+어/EE+두/VB+어/EE+이/VB
려둬줄	리/VB+어/EE+두/VB+어/EE+주/VB+ㄹ/EE
려둬줘	리/VB+어/EE+두/VB+어/EE+주/VB+어/EE
려뒀	리/VB+어/EE+두/VB+었/EE
려드	리/VB+어/EE+들/VB
려든	리/VB+어/EE+들/VB+ㄴ/EE|리/VB+어/EE+들/VB
려려	리/VB+어/EE+리/VB+어/EE
려려와	리/VB+어/EE+리/VB+어/EE+오/VB+아/EE
려렸	리/VB+어/EE+아/EE+리/VB+었/EE|리/VB+어/EE+리/VB+었/EE
려른	리/VB+어/EE+르/VB+ㄴ/EE
려린	리/VB+어/EE+리/VB+ㄴ/EE
려릴	리/VB+어/EE+리/VB+ㄹ/EE
려릴테	리/VB+어/EE+리/VB+ㄹ/EE+터/NN+이/VB
려림	리/VB+어/EE+리/VB+ㅁ/EE
려립	리/VB+어/EE+리/VB+ㅂ/EE
려문	리/VB+어/EE+물/VB+ㄴ/EE
려본	리/VB+어/EE+보/VB+ㄴ/EE
려볼	리/VB+어/EE+보/VB+ㄹ/EE
려봄	리/VB+어/EE+보/VB+ㅁ/EE
려봅	리/VB+어/EE+보/VB+ㅂ/EE
려봐	리/VB+어/EE+보/VB+아/EE
려봤	리/VB+어/EE+보/VB+았/EE
려봤댔	리/VB+어/EE+보/VB+았/EE+다/EE+하/VB+았/EE
려부렀	리/VB+어/EE+불/VB+었/EE
려선	리/VB+어/EE+서/VB+ㄴ/EE|리/VB+어/EE+서/EE+ㄴ/JJ
려설	리/VB+어/EE+서/EE+ㄹ/JJ
려세	리/VB+어/EE+시/EE+어/EE|리/VB+어/EE+시/EE+어/EE+이/VB
려셔	리/VB+어/EE+시/EE+어/EE
려셨	리/VB+어/EE+시/EE+었/EE|리/VB+어/EE+시/VB+었/EE
려신	리/VB+어/EE+시/EE+ㄴ/EE
려실	리/VB+어/EE+시/EE+ㄹ/EE
려십	리/VB+어/EE+시/EE+ㅂ/EE
려쓴	리/VB+어/EE+쓰/VB+ㄴ/EE
려쓸	리/VB+어/EE+쓰/VB+ㄹ/EE
려씀	리/VB+어/EE+쓰/VB+ㅁ/EE
려엔	리/VB+어/EE+에/JJ+ㄴ/JJ
려여	리/VB+어/EE+이/VB+어/EE
려였	리/VB+어/EE+았/EE|리/VB+어/EE+이/VB+었/EE
려온	리/VB+어/EE+오/VB+ㄴ/EE
려올	리/VB+어/EE+오/VB+ㄹ/EE
려옴	리/VB+어/EE+오/VB+ㅁ/EE
려옵	리/VB+어/EE+오/VB+ㅂ/EE
려와	리/VB+어/EE+오/VB+아/EE
려왔	리/VB+어/EE+오/VB+았/EE
려왔랬	리/VB+어/EE+오/VB+았/EE+라/EE+하/VB+았/EE
려요	리/VB+어/EE+이/VB+오/EE
려우	렵/VB|렵/VB+으/EE
려우셨	렵/VB+시/EE+었/EE
려우신	렵/VB+시/EE+ㄴ/EE
려우신봐	렵/VB+시/EE+ㄴ/EE+보/VB+아/EE
려우실	렵/VB+으/EE+시/EE+ㄹ/EE|렵/VB+시/EE+ㄹ/EE
려우십	렵/VB+시/EE+ㅂ/EE
려우와	렵/VB+으/EE+오/VB+아/EE
려운	리/VB+어/EE+오/VB+ㄴ/JJ|렵/VB+ㄴ/EE+에/JJ|렵/VB+ㄴ/EE|렵/VB+은/EE|리/VB+어/EE+우/VB+ㄴ/EE
려운게	렵/VB+ㄴ/EE+것/NN+이/JJ
려울	렵/VB+ㄹ/EE
려울텐	렵/VB+을/EE+터/NN+이/VB+ㄴ/EE
려움	렵/VB+ㅁ/EE
려워	렵/VB+어/EE+이/VB|렵/VB+어/EE|렵/VB+어/EE+에/JJ
려워긴	렵/VB+어/EE+기/EE+ㄴ/JJ
려워실	렵/VB+어/EE+시/EE+ㄹ/EE
려워였	렵/VB+어/EE+이/VB+었/EE
려워인	렵/VB+어/EE+이/VB+ㄴ/EE
려워져	렵/VB+어/EE+지/VB+어/EE
려워졌	렵/VB+어/EE+지/VB+었/EE
려워진	렵/VB+어/EE+지/VB+ㄴ/EE
려워질	렵/VB+어/EE+지/VB+ㄹ/EE|렵/VB+어/EE+ㄹ/EE+지/EE
려워짐	렵/VB+어/EE+지/VB+ㅁ/EE
려워집	렵/VB+어/EE+지/VB+ㅂ/EE
려워하	렵/VB+어/EE+지/VB
려워한	렵/VB+어/EE+하/VB+ㄴ/EE
려워할	렵/VB+어/EE+하/VB+ㄹ/EE
려워함인	렵/VB+어/EE+하/VB+ㅁ/EE+이/VB+ㄴ/EE
려워했	렵/VB+어/EE+하/VB+았/EE
려웠	렵/VB+었/EE|리/VB+어/EE+우/VB+었/EE
려웠봐	렵/VB+었/EE+보/VB+아/EE
려웠졌	렵/VB+어/EE+지/VB+었/EE
려인	리/VB+어/EE+이/VB+ㄴ/EE
려일	리/VB+어/EE+이/VB+ㄹ/EE
려잖	리/VB+어/EE+지/EE+않/VB
려져	리/VB+어/EE+지/VB+어/EE|리/VB+어/EE+지/VB+어/EE+하/VB
려져간	리/VB+어/EE+지/VB+어/EE+가/VB+ㄴ/EE
려져렸	리/VB+어/EE+지/VB+어/EE+리/VB+었/EE
려져온	리/VB+어/EE+지/VB+어/EE+오/VB+ㄴ/EE
려져왔	리/VB+어/EE+지/VB+어/EE+오/VB+았/EE
려졌	리/VB+어/EE+지/VB+었/EE
려졌텐	리/VB+어/EE+지/VB+었/EE+터/NN+이/VB
려준	리/VB+어/EE+주/VB+ㄴ/EE
려줄	리/VB+어/EE+주/VB+ㄹ/EE
려줄요	리/VB+어/EE+주/VB+ㄹ/EE+이/VB+오/EE
려줌	리/VB+어/EE+주/VB+ㅁ/EE
려줍	리/VB+어/EE+주/VB+ㅂ/EE
려줘	리/VB+어/EE+주/VB+어/EE
려줬	리/VB+어/EE+주/VB+었/EE
려진	리/VB+어/EE+어지/VB+ㄴ/EE|리/VB+어/EE+지/VB+ㄴ/JJ|리/VB+어/EE+지/VB+ㄴ/EE
려진린	리/VB+어/EE+지/VB+ㄴ/EE+리/VB+ㄴ/EE
려질	리/VB+어/EE+지/EE+ㄹ/JJ|리/VB+어/EE+지/VB+ㄹ/EE
려짐	리/VB+어/EE+지/VB+ㅁ/EE
려짐임	리/VB+어/EE+지/VB+ㅁ/EE+이/VB+ㅁ/EE
려집	리/VB+어/EE+지/VB+ㅂ/EE
려처	리치/VB+어/EE
려쳐	리/VB+어/EE+치/VB+어/EE
려쳐준	르치/VB+어/EE+주/VB+ㄴ/EE
려쳤섰	리/VB+어/EE+치/VB+었/EE+서/VB+었/EE
려친	리/VB+어/EE+치/VB+ㄴ/EE
려픈	리/VB+어/EE+프/VB+ㄴ/EE|리/VB+어/EE+싶/VB+은/EE
려한	리/VB+어/EE+하/VB+ㄴ/EE
려할	리/VB+어/EE+하/VB+ㄹ/EE
려할텐	리/VB+어/EE+하/VB+ㄹ/EE+터/NN+이/VB+ㄴ/EE
려해	리/VB+어/EE+하/VB+아/EE
려했	리/VB+어/EE+하/VB+았/EE
려힌	리/VB+어/EE+히/VB+ㄴ/EE
련	려/NN+이/VB+ㄴ/EE|이/VB+려/EE+ㄴ/JJ|리/VB+어/EE+ㄴ/JJ|려/EE+ㄴ/EE
렬	려/NN+ㄹ/JJ
렵	럽/XV|럽/NN
렵혀진	럽히/VB+어/EE+지/VB+ㄴ/EE
렷	리/VB+었/EE|리/VB+엇/EE
렸	렇/VB+었/EE|이리/VB+었/EE|리/VB+었/EE|리/NA+었/EE
렸간	리/VB+었/EE+가/EE+ㄴ/JJ
렸게	리/VB+었/EE+것/NN+이/JJ
렸다	리/VB+었/EE
렸단	리/VB+었/EE+다/JJ+ㄴ/JJ
렸땐	리/VB+었/EE+때/NN+ㄴ/JJ
렸봐	리/VB+었/EE+보/VB+아/EE
렸여	리/VB+었/EE+아/EE
렸인	리/VB+었/EE+이/VB+ㄴ/EE
렸잖	리/VB+었/EE+지/EE+않/VB
렸쥬	리/VB+었/EE+지/EE+유/EE
렸테	리/VB+었/EE+터/NN+이/VB
렸한	리/VB+었/EE+하/VB+ㄴ/EE
렸했	렬/NN+하/XV+았/EE
렸혔	리/VB+었/EE+히/VB+었/EE
롄	례/NN+ㄴ/JJ|례/NN+이/VB+ㄴ/EE
롑	례/NN+이/VB+ㅂ/EE
로	이/VB+고/EE|노하/VB|이/VB|고/EE|도/NN|노/NN+하/XV|러/EE
로독	도/EE+록/EE
로와	롭/XV+아/EE|롭/VB+아/EE
로와일	롭/XV+아/EE+이/VB+ㄹ/EE
로와져	롭/VB+아/EE+지/VB+어/EE
로와졌	롭/VB+아/EE+지/VB+었/EE
로와진	롭/VB+아/EE+지/VB+ㄴ/EE|롭/XV+아/EE+지/VB+ㄴ/EE
로와질	롭/XV+아/EE+지/VB+ㄹ/EE
로와한	롭/VB+아/EE+하/VB+ㄴ/EE
로와할	롭/VB+아/EE+하/VB+ㄹ/EE
로와했	롭/VB+아/EE+하/VB+았/EE|롭/XV+아/EE+하/VB+았/EE
로왔	롭/XV+았/EE|롭/VB+았/EE
로우	롭/VB+으/EE|롭/XV|롭/VB|롭/XV+으/EE
로우셨	롭/VB+으/EE+시/EE+었/EE
로우신	롭/XV+시/EE+ㄴ/EE
로우신봐	롭/VB+시/EE+ㄴ/EE+보/VB+아/EE
로우실	롭/XV+시/EE+ㄹ/EE|롭/VB+시/EE+ㄹ/EE
로우심	롭/VB+으/EE+시/EE+ㅁ/EE
로우인	롭이/VB+ㄴ/EE
로운	롭/VB+ㄴ/EE+이/VB|롭/XV+은/EE|롭/VB+ㄴ/EE|롭/XV+ㄴ/EE|롭/VB+은/EE
로운인	롭/XV+ㄴ/EE+이/VB+ㄴ/EE
로운한	롭/VB+ㄴ/EE+하/XV+ㄴ/EE
로울	롭/VB+ㄹ/EE|롭/XV+ㄹ/EE
로움	롭/XV+음/EE|롭/XV+ㅁ/EE|롭/VB+ㅁ/EE
로움러움	롭/XV+ㅁ/EE+럽/VB+ㅁ/EE
로움엔	롭/XV+ㅁ/EE+에/JJ+ㄴ/JJ
로움였	롭/XV+ㅁ/EE+이/VB+었/EE
로움인	롭/VB+ㅁ/EE+이/VB+ㄴ/EE|롭/XV+ㅁ/EE+이/VB+ㄴ/EE
로움일	롭/XV+ㅁ/EE+이/VB+ㄹ/EE
로워	롭/VB+어/EE|롭/VB+아/EE|롭/XV+어/EE
로워본	롭/XV+어/EE+보/VB+ㄴ/EE
로워였	롭/VB+어/EE+았/EE
로워져	롭/XV+어/EE+지/VB+어/EE|롭/VB+어/EE+지/VB+어/EE
로워져일	롭/VB+어/EE+지/VB+어/EE+이/VB+ㄹ/EE
로워졌	롭/VB+어/EE+지/VB+었/EE|롭/XV+어/EE+지/VB+었/EE
로워진	롭/VB+어/EE+지/VB+ㄴ/EE|롭/XV+아/EE+지/VB+ㄴ/EE|롭/XV+어/EE+지/VB+ㄴ/EE
로워질	롭/VB+어/EE+지/VB+ㄹ/EE|롭/XV+어/EE+지/VB+ㄹ/EE
로워짐	롭/XV+어/EE+지/VB+ㅁ/EE|롭/VB+어/EE+지/VB+ㅁ/EE
로워집	롭/XV+어/EE+지/VB+ㅂ/EE|롭/VB+어/EE+지/VB+ㅂ/EE
로워한	롭/VB+어/EE+하/VB+ㄴ/EE
로워할	롭/VB+어/EE+하/VB+ㄹ/EE|롭/XV+어/EE+하/VB+ㄹ/EE
로워함	롭/VB+어/EE+하/VB+ㅁ/EE
로워합	롭/VB+어/EE+하/VB+ㅂ/EE
로워해	롭/VB+어/EE+하/VB+아/EE
로워했	롭/VB+어/EE+하/VB+았/EE|롭/XV+어/EE+하/VB+았/EE
로웠	롭/VB+었/EE|롭/XV+었/EE
론	로/JJ+ㄴ/JJ|로/MA+이/VB+ㄴ/EE
롤	로/MA+이/VB+ㄹ/EE|를/JJ
롬	롭/VB+ㅁ/EE
롯	곳/NN
뢴	뢰/VB+ㄴ/EE
뢸	뢰/VB+ㄹ/EE
룀	뢰/VB+ㅁ/EE
료	려/EE
룐	료/NN+이/VB+ㄴ/EE
루	르/VB+우/EE|로/MA|로/JJ
룬	루/NN+ㄴ/JJ|루/NN+이/VB+ㄴ/EE|루/VB+ㄴ/EE|루/JJ+ㄴ/JJ|루/JJ+이/VB+ㄴ/EE
룰	르/VB+ㄹ/EE|루/VB+ㄹ/EE|루/NN+ㄹ/JJ|루/VB+ㄹ/EE+이/VB
룸	루/VB+ㅁ/EE
룹	루/VB+ㅂ/EE
룻	릇/NN|루/NN
뤄	루어/VB|루/VB+어/EE|루/VB+어/EE+어/EE
뤄갈	루/VB+어/EE+가/VB+ㄹ/EE
뤄긴	루어/VB+기/EE+ㄴ/JJ
뤄길	루어/VB+기/EE+ㄹ/JJ
뤄낸	루/VB+어/EE+내/VB+ㄴ/EE
뤄낼	루/VB+어/EE+내/VB+ㄹ/EE
뤄냈	루/VB+어/EE+내/VB+었/EE
뤄냈잖	루/VB+어/EE+내/VB+었/EE+지/EE+않/VB
뤄논	루/VB+어/EE+놓/VB+ㄴ/EE
뤄된	루/VB+어/EE+되/XV+ㄴ/EE
뤄둔	루/VB+어/EE+두/VB+ㄴ/EE
뤄둘	루/VB+어/EE+두/VB+ㄹ/EE
뤄뒀	루/VB+어/EE+두/VB+었/EE
뤄렸	루/VB+어/EE+리/VB+었/EE
뤄본	루/VB+어/EE+보/VB+ㄴ/EE
뤄볼	루/VB+어/EE+보/VB+ㄹ/EE
뤄봐	루/VB+어/EE+보/VB+아/EE
뤄선	루/VB+어/EE+서/EE+ㄴ/JJ
뤄온	루/VB+어/EE+오/VB+ㄴ/EE
뤄왔	루/VB+어/EE+오/VB+았/EE
뤄져	루/VB+어/EE+지/VB+어/EE|루어/VB+지/VB+어/EE
뤄져온	루어/VB+지/VB+어/EE+오/VB+ㄴ/EE
뤄져왔	루어/VB+지/VB+어/EE+오/VB+았/EE|루/VB+어/EE+지/VB+어/EE+오/VB+았/EE
뤄졌	루어/VB+지/VB+었/EE|루/VB+어/EE+지/VB+었/EE
뤄준	루어/VB+지/VB+ㄴ/EE|루/VB+어/EE+주/VB+ㄴ/EE
뤄진	루/VB+어/EE+지/VB+ㄴ/EE|루어/VB+지/VB+ㄴ/EE
뤄질	루어/VB+지/VB+ㄹ/EE|루/VB+어/EE+지/VB+ㄹ/EE|루어/VB+ㄹ/EE+지/EE
뤄짐	루어/VB+지/VB+ㅁ/EE
뤘	루/VB+었/EE
류	리/VB+유/EE|유/NN|리/VB+우/EE
른	르/VB+ㄴ/EE
른긴	르/VB+기/EE+ㄴ/JJ
른디	르/VB+ㄴ/EE+지/EE
른신	르/VB+시/EE+ㄴ/EE
른여	르/VB+ㄴ/EE+아/EE
른였	르/VB+ㄴ/EE+았/EE
른인	르/VB+ㄴ/EE+이/VB+ㄴ/EE
른한	르/VB+ㄴ/EE+하/XV+ㄴ/EE+이/VB|르/VB+ㄴ/EE+하/XV+ㄴ/EE
른할	르/VB+ㄴ/EE+하/XV+ㄹ/EE
른해	르/VB+ㄴ/EE+하/VB+아/EE
른했	르/VB+ㄴ/EE+하/XV+았/EE
를	르/VB+ㄹ/EE
를게	르/VB+ㄹ/EE+것/NN+이/JJ
를엔	르/VB+ㄹ/EE+에/JJ+ㄴ/JJ
를진	르/VB+ㄹ/EE+지/EE+이/VB+ㄴ/EE
를테	르/VB+ㄹ/EE+터/NN+이/VB
를텐	르/VB+ㄹ/EE+터/NN+이/VB+ㄴ/EE
를한	르/VB+ㄹ/EE+하/XV+ㄴ/EE
를할	르/VB+ㄹ/EE+하/XV+ㄹ/EE
름	르/VB+ㅁ/EE
름닌	르/VB+ㅁ/EE+니/VB+ㄴ/EE
름닐	르/VB+ㅁ/EE+니/VB+ㄹ/EE
름라고	르/VB+ㅁ/EE
름일	르/VB+ㅁ/EE+이/VB+ㄹ/EE
름한	르/VB+ㅁ/EE+하/XV+ㄴ/EE
름합	르/VB+ㅁ/EE+하/VB+ㅂ/EE
릅	르/VB+ㅂ/EE
릎	릅/VB
리	라/MA|이/VB|미/VB|러/NN+하/XV+아/EE|히/MA|러/VB+아/EE|려/VB|라/NN|르이/VB
리어	려/VB
리온	어/EE+려오/VB+ㄴ/EE
리우	립/VB|립/VB+으/EE
리우십	립/VB+시/EE+ㅂ/EE
리운	립/VB+은/EE|립/VB+ㄴ/EE
리울	립/VB+ㄹ/EE
리움	립/VB+ㅁ/EE
리워	립/VB+어/EE|립/NN+어/EE|립/VB+어/EE+이/VB
리워인	립/VB+어/EE+이/VB+ㄴ/EE
리워져	립/VB+어/EE+지/VB+어/EE
리워졌	립/VB+어/EE+지/VB+었/EE
리워진	립/VB+어/EE+지/VB+ㄴ/EE
리워질	립/VB+어/EE+지/VB+ㄹ/EE
리워집	립/VB+어/EE+지/VB+ㅂ/EE
리워한	립/VB+어/EE+하/VB+ㄴ/EE
리워함	립/VB+어/EE+하/VB+ㅁ/EE
리워해	립/VB+어/EE+하/VB+아/EE
리워했	립/VB+어/EE+하/VB+았/EE
리웠	립/VB+었/EE
린	리/NN+이/VB+ㄴ/EE|리/VB+ㄴ/EE|리/MA+ㄴ/JJ|리/NN+ㄴ/JJ|리/XN+이/VB+ㄴ/EE|리/XN+ㄴ/JJ
린느	리/VB+ㄴ/EE+늘/VB
린댔	리/VB+ㄴ/EE+다/EE+하/VB+았/EE
린봐	리/VB+ㄴ/EE+보/VB+아/EE
린였	리/VB+ㄴ/EE+았/EE
린요	리/VB+ㄴ/EE+이/VB+오/EE
린인	리/VB+ㄴ/EE+이/VB+ㄴ/EE
린함	리/VB+ㄴ/EE+하/VB+ㅁ/EE
릴	리/NN+이/VB+ㄹ/EE|리/VB+ㄹ/EE
릴건	리/VB+ㄹ/EE+것/NN+이/VB+ㄴ/EE
릴깝	리/VB+ㄹ/EE+까/EE+이/VB+ㅂ/EE
릴땐	리/VB+ㄹ/EE+때/NN+ㄴ/JJ
릴봐	리/VB+ㄹ/EE+보/VB+아/EE
릴여릴	리/VB+ㄹ/EE+이/VB+어/EE+리/VB+ㄹ/EE
릴잘	리/VB+ㄹ/EE+자/VB+ㄹ/EE
릴쳤	리/NN+ㄹ/JJ+치/VB+었/EE
릴테	리/VB+ㄹ/EE+터/NN+이/VB
릴텐	리/VB+ㄹ/EE+터/NN+이/VB+ㄴ/EE
릴한	리/VB+ㄹ/EE+하/VB+ㄴ/EE|리/VB+ㄹ/EE+하/XV+ㄴ/EE|리/VB+ㄹ/EE+ㄹ/EE+하/VB+ㄴ/EE
릴할	리/VB+ㄹ/EE+ㄹ/EE+하/VB+ㄹ/EE
림	리/VB|리/NN+ㅁ/EE|어/EE+리/VB+ㅁ/EE|리/VB+ㅁ/EE
림UNRICHTIG	리/VB+ㅁ/EE+u/SL+n/SL+r/SL+i/SL+c/SL+h/SL+t/SL+i/SL+g/SL
림남	리/VB+ㅁ/EE+나/VB+ㅁ/EE
림름	리/VB+ㅁ/EE+르/VB+ㅁ/EE
림심	리/VB+ㅁ/EE+시/VB+ㅁ/EE
림여	리/NN+ㅁ/EE+아/EE|리/VB+ㅁ/EE+아/EE
림인	리/VB+ㅁ/EE+이/VB+ㄴ/EE
림일	리/VB+ㅁ/EE+이/VB+ㄹ/EE
림입	리/VB+ㅁ/EE+이/VB+ㅂ/EE
림한	리/VB+ㅁ/EE+하/XV+ㄴ/EE
림할	리/NN+ㅁ/EE+하/XV+ㄹ/EE
림해	리/VB+ㅁ/EE+하/XV+아/EE
립	리/VB+ㅂ/EE+이/VB|어/EE+리/VB+ㅂ/EE|리/VB+ㅂ/EE|리/NN+이/VB+ㅂ/EE|아/EE+리/VB+ㅂ/EE
릿	리/NN
맀	리/VB+었/EE
마	말/VB|만/JJ|말이/VB|아/EE+말/VB|미/NN|맛/VB|말/VB+아/EE+이/VB|말/VB+아/EE|말/NN+이/VB|말/VB+ㄹ/EE
마길	말/VB+기/EE+ㄹ/JJ
마다	말/VB+나/EE
마라	말/VB+아/EE
마러	말/VB+어/EE
마세	말/VB+시/EE+어/EE+이/VB|말/VB+시/EE+어/EE
마셔	말/VB+시/EE+어/EE
마셨	말/VB+시/EE+었/EE
마쇼	말/VB+시/EE+오/EE
마슈	말/VB+시/EE+우/EE|말/VB+시/EE+유/EE
마십	말/VB+시/EE+ㅂ/EE
마여	아/EE+말이/VB+어/EE|말이/VB+어/EE
마였	말이/VB+었/EE
마와	맙/VB+아/EE|맙/VB+어/EE
마왔	맙/VB+았/EE
마요	말/VB+오/EE
마우	맙/VB
마우신	맙/VB+시/EE+ㄴ/EE|맙/VB+으/EE+시/EE+ㄴ/EE
마운	맙/VB+ㄴ/EE|맙/VB+은/EE
마울	맙/VB+ㄹ/EE+ㄹ/EE|맙/VB+ㄹ/EE
마움	맙/VB+ㅁ/EE
마워	맙/VB+어/EE
마워여	맙/VB+어/EE+이/VB+어/EE
마워였	맙/VB+어/EE+이/VB+었/EE
마워인	맙/VB+어/EE+이/VB+ㄴ/EE
마워한	맙/VB+어/EE+하/VB+ㄴ/EE
마워할	맙/VB+어/EE+하/VB+ㄹ/EE
마워해	맙/VB+어/EE+하/VB+아/EE
마워했	맙/VB+어/EE+하/VB+았/EE
마웠	맙/VB+었/EE|맙/VB+았/EE
마일	말이/VB+ㄹ/EE
마진	말/VB+지/EE+ㄴ/JJ
마하	말않/VB
마한	맣/NN+하/XV+ㄴ/EE|말하/VB+ㄴ/EE|말하/VB|만/NN+하/XV+ㄴ/EE
막	박/VB
만	마/EE+는/EE|말/VB|맣/VB+ㄴ/EE|마/NN+이/VB+ㄴ/EE|마/NN+ㄴ/JJ|말/VB+ㄴ/EE|마/VB+ㄴ/EE|마/MA+ㄴ/JJ
만였	말/VB+ㄴ/EE+이/VB+었/EE
만한	마/NN+하/XV+ㄴ/EE
많	맣/VB
말	맡/VB|마/VB+ㄹ/EE|마/NN+ㄹ/JJ|맣/VB+ㄹ/EE
말라	마르/VB+아/EE
말라간	마르/VB+어/EE+가/VB+ㄴ/EE|마르/VB+아/EE+가/VB+ㄴ/EE
말라갈	마르/VB+아/EE+가/VB+ㄹ/EE
말라갔	마르/VB+아/EE+가/VB+았/EE
말라려	마르/VB+아/EE+리/VB+어/EE
말라렸	마르/VB+아/EE+리/VB+었/EE
말라린	마르/VB+아/EE+리/VB+ㄴ/EE
말라릴	마르/VB+아/EE+리/VB+ㄹ/EE
말라였	마르/VB+아/EE+이/VB+었/EE
말라왔	마르/VB+아/EE+오/VB+았/EE
말라졌	마르/VB+아/EE+지/VB+었/EE
말라진	마르/VB+아/EE+지/VB+ㄴ/EE
말라키	마르/VB+아/EE+하/VB+기/EE
말라한	마르/VB+아/EE+하/VB+ㄴ/EE
말랐	마르/VB+았/EE
말왔	마르/VB+오/VB+았/EE
맙	말/VB+ㅂ/EE|마/NN+이/VB+ㅂ/EE
매	맣/VB+아/EE
매우	맵/VB|맵/VB+으/EE
매운	맵/VB+ㄴ/EE|맨/NN|맵/VB+은/EE
매워	맵/VB+어/EE
매워인	맵/VB+어/EE+이/VB+ㄴ/EE
매웠	맵/VB+었/EE
매입	마/NN+이/VB+ㅂ/EE
맨	매/NN+이/VB+ㄴ/EE|매/VB+ㄴ/EE
맬	매/VB+ㄹ/EE
맴	매/VB+ㅁ/EE
맸	맣/VB+았/EE|매/VB+었/EE
맸다	매/VB+었/EE
맹	명/NN
머	멀/VB|멓/VB
머언	멀/VB+ㄴ/EE
머잖	멀/VB+지/EE+않/VB
머쟎	멀/VB+지/EE+않/VB
먼	머/NN+이/VB+ㄴ/EE|멀/VB+ㄴ/EE|멓/VB+ㄴ/EE|이멀/VB+ㄴ/EE+./SY|뭐/NN+이/VB+ㄴ/EE|멀/VB+ㄴ/EE+이/VB
먼게	멓/VB+ㄴ/EE+거/NN+이/JJ
먼겨	멀/VB+ㄴ/EE+것/NN+이/VB+어/EE
먼덴	멀/VB+ㄴ/EE+데/NN+이/VB+ㄴ/EE
먼델	멀/VB+ㄴ/EE+데/NN+ㄹ/JJ
먼먼	멀/VB+ㄴ/EE+멀/VB+ㄴ/EE
멀	머/NN+ㄹ/JJ
멀혀갈	먹히/VB+어/EE+가/VB+ㄹ/EE
멉	멀/VB+ㅂ/EE
메	에/JJ
멘	메/NN+이/VB+ㄴ/EE|메/VB+ㄴ/EE|메/NN+ㄴ/JJ
멘선	메/NN+이/VB+ㄴ/EE+서/JJ+ㄴ/JJ
멜	메/NN+이/VB+ㄹ/EE|메/VB+ㄹ/EE
멥	메/VB+ㅂ/EE
멨	멓/VB+었/EE|메/VB+었/EE
며	미/VB+어/EE+어/EE|미/VB+어/EE|미/VB+어/EE+아/EE|면/EE|미/VB+어/EE+이/VB
며간	미/VB+어/EE+가/VB+ㄴ/EE
며갈	미/VB+어/EE+가/VB+ㄹ/EE
며갔	미/VB+어/EE+가/VB+았/EE
며났	미/VB+어/EE+나/VB+았/EE
며낸	미/VB+어/EE+내/VB+ㄴ/EE
며낼	미/VB+어/EE+내/VB+ㄹ/EE
며냄	미/VB+어/EE+내/VB+ㅁ/EE
며냈	미/VB+어/EE+내/VB+었/EE
며논	미/VB+어/EE+놓/VB+ㄴ/EE
며놨	미/VB+어/EE+놓/VB+았/EE
며놨텐	미/VB+어/EE+놓/VB+았/EE+터/NN+이/VB+ㄴ/EE
며댄	미/VB+어/EE+대/VB+ㄴ/EE
며댈	미/VB+어/EE+대/VB+ㄹ/EE
며댔	미/VB+어/EE+대/VB+었/EE
며드	미/VB+어/EE+들/VB
며본	미/VB+어/EE+보/VB+ㄴ/EE
며봤	미/VB+어/EE+보/VB+았/EE
며온	미/VB+어/EE+오/VB+ㄴ/EE
며와	미/VB+어/EE+오/VB+아/EE
며왔	미/VB+어/EE+오/VB+았/EE
며져	미/VB+어/EE+지/VB+어/EE
며졌	미/VB+어/EE+지/VB+었/EE
며준	미/VB+어/EE+주/VB+ㄴ/EE
며줄	미/VB+어/EE+주/VB+ㄹ/EE
며진	미/VB+어/EE+지/EE+ㄴ/JJ|미/VB+어/EE+지/VB+ㄴ/EE
며질	미/VB+어/EE+지/VB+ㄹ/EE
면	고/EE|명/NN
몄	미/VB+었/EE
몇	며/NN
모	몰/VB|보/VB
모뎌	못하/VB+아/EE
모본	몰보/VB+ㄴ/EE
목	못/VB
몬	몰/VB|몰/VB+ㄴ/EE|모/NN+이/VB+ㄴ/EE|모/NN+ㄴ/JJ
몰	모르/VB|모/VB
몰라	모르/VB+아/EE+이/VB|모르/VB+아/EE|모르/VB
몰라뵈	모르/VB+아/EE+뵙/VB
몰라였	모르/VB+아/EE+이/VB+었/EE
몰라요	모르/VB+아/EE+이/VB+오/EE
몰라인	모르/VB+아/EE+이/VB+ㄴ/EE
몰라한	모르/VB+아/EE+하/VB+ㄴ/EE
몰라해	모르/VB+아/EE+하/VB+아/EE
몰라했	모르/VB+아/EE+하/VB+았/EE
몰랐	모르/VB+았/EE|모르/VB+았/EE+이/VB
몰러	모르/VB+어/EE
몰렀	모르/VB+었/EE
몰루	모르/VB+우/EE
못	맛/MA
못했	하/VB+았/EE
뫄	모으/VB+아/EE|모으/VB+아/EE+으/VB
뫄뒀	모으/VB+아/EE+두/VB+었/EE
뫘	모으/VB+았/EE+으/VB
무	물/VB|문/NN+이/VB
무셨	물/VB+시/EE+었/EE
무어	뭐/NN
무질봐	뭇지/VB+ㄹ/EE+보/VB+아/EE
문	물/VB|무/NN+ㄴ/JJ|무/NN+ㄴ/EE|물/VB+ㄴ/EE|물/VB+ㄴ/EE+에/JJ|무/NN+이/VB+ㄴ/EE
물	묻하/VB|묵/VB+ㄹ/EE|무/NN+ㄹ/JJ|무르/VB|묻/VB+아/EE|묻/NN|묻/VB|묻/VB+시/EE|무/VB|묻/VB+어/EE
물갈	묻가/VB+ㄹ/EE
물갔	묻가/VB+았/EE
물길	묻/VB+기/EE+ㄹ/JJ
물댈	묻대/VB+ㄹ/EE
물댔	묻대/VB+었/EE
물러	무르/VB+어/EE|모르/VB+어/EE|무르/VB+어/EE+하/VB
물러렸	무르/VB+어/EE+리/VB+었/EE
물러온	무르/VB+어/EE+오/VB+ㄴ/EE
물러와	무르/VB+어/EE+오/VB+아/EE
물러줄	무르/VB+어/EE+주/VB+ㄹ/EE
물러진	무르/VB+어/EE+지/VB+ㄴ/EE
물러했	무르/VB+어/EE+하/VB+았/EE
물렀	무르/VB+었/EE
물른	무르/VB+ㄴ/EE
물를	무르/VB+ㄹ/EE
물를텐	무르/VB+ㄹ/EE+터/NN+이/VB+ㄴ/EE
물마	묻말/VB
물본	묻보/VB+ㄴ/EE
물볼	묻보/VB+ㄹ/EE
물봅	묻보/VB+ㅂ/EE
물봐	묻보/VB+아/EE
물봤	묻보/VB+았/EE
물선	묻/VB+서/EE+ㄴ/JJ
물세	묻/VB+시/EE+어/EE
물셔	묻/VB+시/EE+어/EE|묻/VB+시/EE+시/EE+어/EE
물셨	묻/VB+시/EE+었/EE
물신	묻/VB+시/EE+ㄴ/EE|묻/VB+시/EE+시/EE+ㄴ/EE
물실	묻/VB+시/EE+ㄹ/EE
물심	묻/VB+시/EE+ㅁ/EE
물십	묻/VB+시/EE+ㅂ/EE|묻/VB+시/EE+시/EE+ㅂ/EE
물온	묻오/VB+ㄴ/EE
물올	묻오/VB+ㄹ/EE
물와	묻오/VB+아/EE
물왔	묻오/VB+았/EE
물을	묻/VB+ㄹ/EE
물이	묻/VB+니/EE
물잖	무/VB+지/EE+않/VB
물져	묻지/VB+어/EE
물준	묻주/VB+ㄴ/EE
물진	묻지/VB+ㄴ/EE
물할	묻하/VB+ㄹ/EE
묾	물/VB+ㅁ/EE
뭅	무/NN+이/VB+ㅂ/EE
뭇	무/MM|무/NN
뭐	무엇/NN|무엇/NN+이/VB
뭐가뭔	무엇/NN+이/JJ+무엇/NN+이/VB+ㄴ/EE
뭐래	무엇/NN+이/VB+라/EE
뭐랬	무엇/NN+이/VB+라/EE+고/EE+하/VB+았/EE
뭐시	무엇/NN+이/JJ|무엇/NN+이/VB
뭐여	무엇/NN+이/VB+어/EE
뭐였	무엇/NN+이/VB+었/EE
뭐요	무엇/NN+이/VB+오/EE
뭐인	무엇/NN+이이/VB+ㄴ/EE
뭔	무엇/NN+ㄴ/JJ|뭐/NN+이/VB+ㄴ/EE|무엇/NN+이/VB+ㄴ/EE|무엇/NN+ㄴ/EE
뭔갈	무엇/NN+이/VB+ㄴ/EE+가/EE+ㄹ/JJ
뭔진	무엇/NN+이/VB+ㄴ/EE+지/EE+ㄴ/JJ
뭘	뭐/NN+이/VB|뭐/NN+이/VB+ㄹ/EE|무엇/NN+ㄹ/JJ|무엇/NN+으/JJ|무엇/NN+이/VB+ㄹ/EE|무엇/NN+을/JJ|무엇/NN
뭘입	무엇/NN+ㄹ/JJ+이/VB+ㅂ/EE
뭘해	무엇/NN+ㄹ/JJ+하/VB+아/EE|무엇/NN+을/JJ+하/VB+아/EE
뭘했	무엇/NN+ㄹ/JJ+하/VB+았/EE
뭡	무엇/NN+이/VB+ㅂ/EE|뭐/NN+이/VB+ㅂ/EE
뭣	무엇/NN|무엇/NN+이/VB|뭐/NN
뭣긴	무엇/NN+기/EE+ㄴ/JJ
뭣랬	무엇/NN+이/VB+라/EE+하/VB+았/EE
뭣론	무엇/NN+로/JJ+이/VB+ㄴ/EE
뭣여	무엇/NN+아/EE|무엇/NN+어/EE
뭣요	무엇/NN+오/EE
뭣인	무엇/NN+이/VB+ㄴ/EE
뭣일	무엇/NN+이/VB+ㄹ/EE
뭣입	무엇/NN+이/VB+ㅂ/EE
뭣할	무엇/NN+하/VB+ㄹ/EE
뭣합	무엇/NN+하/VB+ㅂ/EE|무엇/NN+하/XV+ㅂ/EE
뭣해	무엇/NN+하/VB+아/EE|무엇/NN+하/XV+아/EE
뭣해해	무엇/NN+하/VB+아/EE+하/VB+아/EE
뭣헐껴	무엇/NN+허/VB+ㄹ/EE+끼/NN+이/VB+어/EE
뭣혀	무엇/NN+허/VB+어/EE
뭬	무엇/NN+이/JJ|무엇/NN+이/VB
므	ㅁ/EE|ㅁ/EE+으/JJ
므해	ㅁ/EE+으/JJ+하/VB+아/EE
믄	믛/VB+ㄴ/EE
믈	므/NN+ㄹ/JJ|물/NN
믈러	무르/VB+어/EE
미	밀/VB|수/NN|메/VB|무/NN
미러	밀/VB+어/EE
미세	밀/VB+시/EE+어/EE
미셨	밀/VB+시/EE+었/EE
미우	밉/VB|밉/VB+으/EE
미운	밉/VB+은/EE|밉/VB+ㄴ/EE
미울	밉/VB+ㄹ/EE
미움	밉/VB+음/EE
미워	밉/VB+어/EE|밉/VB+아/EE
미워셨	밉/VB+어/EE+시/EE+었/EE
미워였	밉/VB+아/EE+았/EE|밉/VB+어/EE+이/VB+었/EE
미워져	밉/VB+어/EE+지/VB+어/EE
미워졌	밉/VB+어/EE+지/VB+었/EE
미워진	밉/VB+어/EE+지/VB+ㄴ/EE
미워질	밉/VB+어/EE+지/VB+ㄹ/EE
미워집	밉/VB+어/EE+지/VB+ㅂ/EE
미워한	밉/VB+아/EE+하/VB+ㄴ/EE
미워할	밉/VB+아/EE+하/VB+ㄹ/EE
미워합	밉/VB+아/EE+하/VB+ㅂ/EE
미워해	밉/VB+아/EE+하/VB+아/EE
미워했	밉/VB+아/EE+하/VB+았/EE
미웠	밉/VB+었/EE
미있	밌/VB
민	미/NN+ㄴ/JJ|밀/VB+ㄴ/EE|미/NN+이/VB+ㄴ/EE|님/XN|미/VB+ㄴ/EE|미/VB+ㄴ/EE+이/VB
민겨	미/NN+이/VB+ㄴ/EE+것/NN+이/VB+어/EE
민해	미/VB+ㄴ/EE+하/VB+아/EE
밀	미/NN+ㄹ/JJ|미/NN+이/VB+ㄹ/EE|미/VB+ㄹ/EE
밈	미/VB+ㅁ/EE
밉	미/VB+ㅂ/EE|밀/VB+ㅂ/EE
밌	미있/VB
밌단	미있/VB+다/JJ+ㄴ/JJ
바	부/NN|밥/NN
바져	빠지/VB+어/EE
바한	부/NN+하/XV+ㄴ/EE
바함	부/NN+하/XV+ㅁ/EE
박	백/NN
반였	법/NN+았/EE
발	박/NN|달/NN|바/NN+이/VB+ㄹ/EE|밝/VB|방/NN
발라	바르/VB+아/EE+하/VB|바르/VB+어/EE|바르/VB+아/EE|어/EE+바르/VB+아/EE
발라간	바르/VB+아/EE+가/VB+ㄴ/EE
발라길	바르/VB+아/EE+기/EE+ㄹ/JJ
발라놔	바르/VB+아/EE+놓/VB+아/EE
발라다	바르/VB+아/EE+달/VB
발라림	바르/VB+아/EE+리/VB+ㅁ/EE
발라봅	바르/VB+아/EE+보/VB+ㅂ/EE
발라요	바르/VB+아/EE+이/VB+오/EE
발라져	바르/VB+아/EE+지/VB+어/EE
발라준	바르/VB+아/EE+주/VB+ㄴ/EE
발라줘	바르/VB+아/EE+주/VB+어/EE
발라진	바르/VB+아/EE+지/VB+ㄴ/EE
발라질	바르/VB+아/EE+지/VB+ㄹ/EE
발랐	바르/VB+았/EE|어/EE+바르/VB+았/EE
발러	바르/VB+어/EE
배	바/NN+이/JJ|대/NN
배낸	베/VB+어/EE+내/VB+ㄴ/EE
백	천/NN
밴	배/NN+이/VB+ㄴ/EE|배/VB+ㄴ/EE
밸	배/NN+ㄹ/JJ|배/VB+ㄹ/EE
뱀	배/VB+ㅁ/EE
뱄	배/VB+었/EE
버	벌/VB
버부	퍼붓/VB
번	전/NN|벌/VB+ㄴ/EE|벌/VB
벌	별/MA
범	법/NN
법	벌/VB+ㅂ/EE|반/NN
벙	범/VB
베	배/NN|벨/NN
벤	베/VB+ㄴ/EE
벨	베/VB+ㄹ/EE
벰	베/VB+ㅁ/EE
벼	볕/NN|비/VB+어/EE+어/EE|비/VB+어/EE+이/VB|비/VB+어/EE+아/EE|비/VB+어/EE|비/VB+어/EE+ㄹ/EE|변/NN
벼간	비/VB+어/EE+가/EE+ㄴ/JJ
벼끈	비/VB+어/EE+끄/VB+ㄴ/EE
벼낸	비/VB+어/EE+내/VB+ㄴ/EE
벼댄	비/VB+어/EE+대/VB+ㄴ/EE
벼댔	비/VB+어/EE+대/VB+었/EE
벼든	비/VB+어/EE+들/VB+ㄴ/EE
벼볼	비/VB+어/EE+보/VB+ㄹ/EE
벼봤	비/VB+어/EE+보/VB+았/EE
벼신	비/VB+어/EE+시/EE+ㄴ/EE
벼올	비/VB+어/EE+오/VB+ㄹ/EE
벼우	볍/VB+으/EE|볍/VB
벼운	볍/VB+ㄴ/EE
벼울	볍/VB+ㄹ/EE
벼움	볍/VB+음/EE|볍/VB+ㅁ/EE
벼웁	볍/VB
벼워	볍/VB+어/EE
벼워져	볍/VB+어/EE+지/VB+어/EE
벼워졌	볍/VB+어/EE+지/VB+었/EE
벼워진	볍/VB+어/EE+지/VB+ㄴ/EE
벼워질	볍/VB+어/EE+지/VB+ㄹ/EE|볍/VB+어/EE+ㄹ/EE+지/NN
벼웠	볍/VB+었/EE
벼졌	비/VB+어/EE+지/VB+었/EE
벼준	비/VB+어/EE+주/VB+ㄴ/EE
벼판	비/VB+어/EE+파/VB+ㄴ/EE
벼팠	비/VB+어/EE+파/VB+았/EE
별긴	벼/VB+기/EE+ㄴ/JJ
별러	벼르/VB+어/EE
별러온	벼르/VB+어/EE+오/VB+ㄴ/EE
별렀	벼르/VB+었/EE
별왔	벼르/VB+오/VB+았/EE
볍	법/NN
볐	비/VB+었/EE
볐여	비/VB+었/EE+아/EE
보	급/NN|뵤/NN
보세	보/VB+시/EE
복	북/VB
본	보/NN+ㄴ/JJ|보/VB+ㄴ/EE
본러	보/VB+ㄴ/EE+렇/VB
본한	보/VB+ㄴ/EE+하/XV+ㄴ/EE
볼	보/VB+ㄹ/EE
볼꺼	보/VB+ㄹ/EE+거/NN+이/VB
볼끄	보/VB+ㄹ/EE+끌/VB
볼땐	보/VB+ㄹ/EE+때/NN+ㄴ/JJ
볼봐	보/VB+ㄹ/EE+보/VB+아/EE
볼인	보/VB+ㄹ/EE+이/VB+ㄴ/EE
볼진	보/VB+ㄹ/EE+지/EE+이/VB+ㄴ/EE
볼테	보/VB+ㄹ/EE+터/NN+이/VB
볼한	보/VB+ㄹ/EE+하/VB+ㄴ/EE
볼할	보/VB+ㄹ/EE+하/XV+ㄹ/EE
볼함	보/VB+ㄹ/EE+하/XV+ㅁ/EE
볼해	보/VB+ㄹ/EE+하/XV+아/EE
볼했	보/VB+ㄹ/EE+하/XV+았/EE
봄	보/VB+ㅁ/EE
봄임	보/VB+ㅁ/EE+이/VB+ㅁ/EE
봄한	보/VB+ㅁ/EE+하/XV+ㄴ/EE|보/VB+ㅁ/EE+하/VB+ㄴ/EE
봅	보/VB+ㅂ/EE
봅건	보/VB+ㅂ/EE+것/NN+ㄴ/JJ
봉	보/VB+ᆼ/EE
봐	보/VB+아/EE
봐감	보/VB+아/EE+가/VB+ㅁ/EE
봐게	보/VB+아/EE+것/NN+이/JJ
봐두	어/EE+보/VB
봐둔	보/VB+아/EE+두/VB+ㄴ/EE
봐둘	보/VB+아/EE+두/VB+ㄹ/EE
봐둬	보/VB+아/EE+두/VB+어/EE
봐뒀	보/VB+아/EE+두/VB+었/EE
봐란	보/VB+아/EE+라/EE+ㄴ/JJ
봐려	보/VB+아/EE+리/VB+어/EE
봐렸	보/VB+아/EE+리/VB+었/EE
봐린	보/VB+아/EE+리/VB+ㄴ/EE
봐릴	보/VB+아/EE+리/VB+ㄹ/EE
봐립	보/VB+아/EE+리/VB+ㅂ/EE
봐볼	보/VB+아/EE+보/VB+ㄹ/EE
봐봐	보/VB+아/EE+보/VB+아/EE
봐선	보/VB+아/EE+서/EE+ㄴ/JJ
봐세	보/VB+아/EE+시/EE+어/EE|보아/VB+시/EE+어/EE
봐셨	보/VB+아/EE+시/EE+었/EE
봐십	보아/VB+시/EE+ㅂ/EE|보/VB+아/EE+시/EE+ㅂ/EE
봐얄	보/VB+아/EE+야/EE+하/VB+ㄹ/EE|보/VB+아/EE+야/EE+ㄹ/JJ
봐였	보/VB+아/EE+이/VB+었/EE
봐온	보/VB+아/EE+오/VB+ㄴ/EE
봐올	보/VB+아/EE+오/VB+ㄹ/EE
봐왔	보/VB+아/EE+오/VB+았/EE
봐준	보/VB+아/EE+주/VB+ㄴ/EE|보아/VB+주/VB+ㄴ/EE
봐줄	보아/VB+주/VB+ㄹ/EE|보/VB+아/EE+주/VB+ㄹ/EE
봐줍	보/VB+아/EE+주/VB+ㅂ/EE
봐줘	보/VB+아/EE+주/VB+어/EE|보아/VB+주/VB+어/EE
봐줬	보/VB+아/EE+주/VB+었/EE|보아/VB+주/VB+었/EE
봐줬으면	보/VB+아/EE+주/VB+었/EE
봐진	보/VB+아/EE+지/VB+ㄴ/EE
봐한	보/VB+아/EE+하/VB+ㄴ/EE
봐할	보/VB+아/EE+하/VB+ㄹ/EE
봐했	보/VB+아/EE+하/VB+았/EE
봐힌	보/VB+아/EE+히/VB+ㄴ/EE
봔	보/VB+아/EE+ㄴ/JJ
봤	보/VB+았/EE
봤갑	보/VB+았/EE+가/EE+이/VB+ㅂ/EE
봤게	보/VB+았/EE+것/NN+이/JJ
봤댔	아/EE+보/VB+았/EE+다/EE+하/VB+았/EE|보/VB+았/EE+다/EE+하/VB+았/EE
봤댔였	보/VB+았/EE+다/EE+하/VB+았/EE+이/VB+었/EE
봤댔일	보/VB+았/EE+다/EE+하/VB+았/EE+이/VB+ㄹ/EE
봤런	보/VB+았/EE+렇/VB+ㄴ/EE
봤봐	보/VB+았/EE+보/VB+아/EE
봤을	보/VB+았/EE+ㄹ/EE
봤잖	보/VB+았/EE+지/EE+않/VB
봤칠	보/VB+았/EE+치/VB+ㄹ/EE
봬	뵈/VB+어/EE|뵙/VB+어/EE
뵈	보이/VB+어/EE|뵙/VB|뵙/VB+으/EE|보이/VB
뵈온	뵙오/VB+ㄴ/EE|뵙/VB+오/EE+ㄴ/EE
뵈올	뵙/VB+ㄹ/EE
뵈우	뵙/VB
뵌	아/EE+뵈/VB+ㄴ/EE|보이/VB+ㄴ/EE|뵈/VB+ㄴ/EE
뵐	아/EE+뵈/VB+ㄹ/EE|뵙/VB+ㄹ/EE|뵈/VB+ㄹ/EE
뵙	뵈/VB+ㅂ/EE|뵈/VB+ㅂ/EE+이/VB|아/EE+뵈/VB+ㅂ/EE
뵜	뵙/VB+었/EE
뵤	보/VB+오/EE
부	붓/VB+시/EE|불/VB|붓/VB|붓/VB+아/EE|보/NN
부걸	붓/VB+것/NN+ㄹ/JJ
부낸	붓내/VB+ㄴ/EE
부댔	붓대/VB+었/EE
부둔	붓두/VB+ㄴ/EE
부러	불/VB+어/EE|어/EE+불/VB+어/EE
부렀	불/VB+었/EE
부세	불/VB+시/EE+어/EE
부셨	불/VB+시/EE+었/EE|붓/VB+시/EE+었/EE
부신	붓/VB+시/EE+ㄴ/EE|불/VB+시/EE+ㄴ/EE
부왔	붓오/VB+았/EE
부우	붓/VB+으/EE
부운	붓/VB+ㄴ/EE|붇/VB+은/EE
부울	붓/VB+ㄹ/EE
부음	붓/VB+ㅁ/EE
부져	붓지/VB+어/EE
부졌	붓지/VB+었/EE
부준	붓주/VB+ㄴ/EE
부줄	붓주/VB+ㄹ/EE
부진	붓지/VB+ㄴ/EE
부질	붓지/VB+ㄹ/EE
부치	붙이/VB
부터였	버/JJ+텀/JJ+이/VB+었/EE
분	아/EE+버리/VB+ㄴ/EE|부/VB+ㄴ/EE|불/VB+ㄴ/EE|부/NN+이/VB+ㄴ/EE
불	붓/VB+ㄹ/EE|부/VB|보/VB+ㄹ/EE|붇/VB+아/EE|붇/VB|부/NN+ㄹ/JJ
불간	붇가/VB+ㄴ/EE
불그	붉/VB+으/EE|붉/MA+으/MA
불난	붇나/VB+ㄴ/EE
불날	붇나/VB+ㄹ/EE
불남	붇나/VB+ㅁ/EE
불났	붇나/VB+았/EE
불러	부르/VB+어/EE+어/EE|부르/VB+어/EE+으/VB|부르/VB+어/EE|부르/VB+어/EE+하/VB
불러간	부르/VB+어/EE+가/VB+ㄴ/EE
불러갈	부르/VB+어/EE+가/VB+ㄹ/EE
불러갔	부르/VB+어/EE+가/VB+았/EE
불러긴	부르/VB+어/EE+기/EE+ㄴ/JJ
불러길	부르/VB+어/EE+기/EE+ㄹ/JJ|부르/VB+어/EE+기/EE+를/JJ
불러꼈	부르/VB+어/EE+끼/VB+었/EE
불러낀	부르/VB+어/EE+끼/VB+ㄴ/EE
불러놨	부르/VB+어/EE+놓/VB+았/EE
불러다	부르/VB+어/EE+달/VB
불러댄	부르/VB+어/EE+대/VB+ㄴ/EE
불러댔	부르/VB+어/EE+대/VB+었/EE
불러려	부르/VB+어/EE+리/VB+어/EE
불러린	부르/VB+어/EE+리/VB+ㄴ/EE
불러릴	부르/VB+어/EE+리/VB+ㄹ/EE
불러본	부르/VB+어/EE+보/VB+ㄴ/EE
불러볼	부르/VB+어/EE+보/VB+ㄹ/EE
불러봄한	부르/VB+어/EE+보/VB+ㅁ/EE+하/VB+ㄴ/EE
불러봅	부르/VB+어/EE+보/VB+ㅂ/EE
불러봐	부르/VB+어/EE+보/VB+아/EE
불러봤	부르/VB+어/EE+보/VB+았/EE
불러샌	부르/VB+어/EE+새/VB+ㄴ/EE
불러세	부르/VB+어/EE+시/EE+어/EE
불러셔	부르/VB+어/EE+시/EE+어/EE
불러셨	부르/VB+어/EE+시/EE+었/EE
불러신	부르/VB+어/EE+시/EE+ㄴ/EE
불러십	부르/VB+어/EE+시/EE+ㅂ/EE
불러온	부르/VB+어/EE+오/VB+ㄴ/EE
불러왔봅	부르/VB+어/EE+오/VB+았/EE+보/VB+ㅂ/EE
불러운	부르/VB+어/EE+우/VB+ㄴ/EE
불러워	부르/VB+어/EE+우/VB+어/EE
불러웠	부르/VB+어/EE+우/VB+었/EE
불러을	부르/VB+어/EE+으/VB+ㄹ/EE
불러잖	부르/VB+었/EE+지/EE+않/VB
불러져	부르/VB+어/EE+지/VB+어/EE
불러졌	부르/VB+어/EE+지/VB+었/EE
불러준	부르/VB+어/EE+주/VB+ㄴ/EE
불러줄	부르/VB+어/EE+주/VB+ㄹ/EE
불러줘	부르/VB+어/EE+주/VB+어/EE
불러줘봐	부르/VB+어/EE+주/VB+어/EE+보/VB+아/EE
불러진	부르/VB+어/EE+지/VB+ㄴ/EE
불러질	부르/VB+어/EE+지/VB+ㄹ/EE
불러했	부르/VB+어/EE+하/VB+았/EE
불러힌	부르/VB+어/EE+히/VB+ㄴ/EE
불렀	부르/VB+었/EE+이/VB|부르/VB+었/EE
불렀옵	부르/VB+었/EE+오/EE+ㅂ/EE
불루	부르/VB+우/EE
불른	붇르/VB+ㄴ/EE
불여진	붙이/VB+어/EE+지/VB+ㄴ/EE
불웠	부르/VB+우/VB+었/EE
불은	붇/VB+ㄴ/EE
붑	부/NN+이/VB+ㅂ/EE|불/VB+ㅂ/EE
붑겼	부/NN+이/VB+ㅂ/EE+기/VB+었/EE
붙여	잇/VB+어/EE+붙/VB
뷥	P/SL
브	븟/VB
브져	부지/VB+어/EE
븟	붓/VB
비	빌/VB|빌이/VB
비곤	빌/VB+고/EE+ㄴ/JJ
비비	빌빌/VB
비옵	빌/VB+오/EE+ㅂ/EE
빈	비/VB+ㄴ/EE|비/NN+ㄴ/JJ|빌/VB+ㄴ/EE
빈곤	비/VB+ㄴ/EE+고/EE+ㄴ/JJ
빈을	비/VB+ㄴ/EE
빈인	비/VB+ㄴ/EE+이/VB+ㄴ/EE
빈일	비/VB+ㄴ/EE+이/VB+ㄹ/EE
빈임	비/VB+ㄴ/EE+이/VB+ㅁ/EE
빌	비/VB+ㄹ/EE|비/VB+ㄹ/EE+이/VB|비/NN+ㄹ/JJ
빔	빌/VB+ㅂ/EE|비/VB+ㅁ/EE
빕	비/NN+이/VB+ㅂ/EE|빌/VB+ㅂ/EE
;;빗	비/NN
빠	쁘/VB+아/EE|쁘/VB+어/EE
빠난게	쁘/VB+아/EE+나/VB+ㄴ/EE+것/NN+이/JJ
빠셨	쁘/VB+아/EE+시/EE+었/EE
빠였	쁘/VB+아/EE+이/VB+었/EE
빠옴	쁘/VB+아/EE+오/VB+ㅁ/EE
빠와	쁘/VB+아/EE+오/VB+아/EE
빠왔	쁘/VB+아/EE+오/VB+았/EE
빠인	쁘/VB+아/EE+이/VB+ㄴ/EE
빠져	쁘/VB+아/EE+지/VB+어/EE|쁘/VB+어/EE+지/VB+어/EE
빠졌	쁘/VB+어/EE+지/VB+었/EE|쁘/VB+아/EE+지/VB+었/EE
빠진	쁘/VB+어/EE+지/VB+ㄴ/EE|쁘/VB+아/EE+지/VB+ㄴ/EE
빠질	쁘/VB+아/EE+지/VB+ㄹ/EE
빠짐	쁘/VB+아/EE+지/VB+ㅁ/EE
빠집	쁘/VB+아/EE+지/VB+ㅂ/EE
빠할	쁘/VB+아/EE+하/VB+ㄹ/EE
빤	빨/VB+ㄴ/EE|빠/NN+이/VB+ㄴ/EE|빠/NN+ㄴ/JJ
빨	빠/NN+ㄹ/JJ
빨라	빠르/VB+아/EE|빠르/VB+어/EE
빨라져	빠르/VB+아/EE+지/VB+어/EE
빨라졌	빠르/VB+어/EE+지/VB+었/EE|빠르/VB+아/EE+지/VB+었/EE
빨라진	빠르/VB+아/EE+지/VB+ㄴ/EE|빠르/VB+어/EE+지/VB+ㄴ/EE
빨라질	빠르/VB+아/EE+지/VB+ㄹ/EE
빨라짐	빠르/VB+어/EE+지/VB+ㅁ/EE|빠르/VB+아/EE+지/VB+ㅁ/EE
빨라집	빠르/VB+아/EE+지/VB+ㅂ/EE
빨랐	빠르/VB+았/EE
빨러	빠르/VB+어/EE
빨리	빠르/VB+이/EE
빰	뺨/NN
빴	쁘/VB+았/EE|쁘/VB+았/EE+이/VB
뺀	빼/VB+ㄴ/EE
뺄	빼/VB+ㄹ/EE
뺄했	빼/VB+ㄹ/EE+하/VB+았/EE
뺍	빼/VB+ㅂ/EE
뺐	빼/VB+었/EE
뻐	쁘/VB+아/EE|쁘/VB+었/EE|뻥/MA|쁘/VB+어/EE
뻐개	뻘겋/VB+어/EE
뻐곤	쁘/VB+어/EE+고/EE+ㄴ/JJ
뻐길	쁘/VB+어/EE+기/EE+ㄹ/JJ
뻐봤	쁘/VB+어/EE+보/VB+았/EE
뻐셨	쁘/VB+어/EE+시/EE+었/EE|쁘/VB+아/EE+시/EE+었/EE
뻐실	쁘/VB+아/EE+시/EE+ㄹ/EE
뻐여	쁘/VB+어/EE+이/VB+어/EE
뻐였	쁘/VB+아/EE+았/EE|쁘/VB+어/EE+았/EE|쁘/VB+어/EE+이/VB+었/EE
뻐졌	쁘/VB+어/EE+지/VB+었/EE
뻐진	쁘/VB+어/EE+지/VB+ㄴ/EE
뻐질	쁘/VB+어/EE+지/VB+ㄹ/EE
뻐집	쁘/VB+어/EE+지/VB+ㅂ/EE
뻐한	쁘/VB+어/EE+하/VB+ㄴ/EE
뻐할	쁘/VB+어/EE+하/VB+ㄹ/EE|쁘/VB+아/EE+하/VB+ㄹ/EE
뻐해	쁘/VB+아/EE+하/VB+아/EE|쁘/VB+어/EE+하/VB+아/EE
뻐했	쁘/VB+아/EE+하/VB+았/EE|쁘/VB+어/EE+하/VB+았/EE
뻣	뼛/NN
뻤	쁘/VB+었/EE
뻿	굄/NN
뼜	삐/VB+었/EE
뽄	뽀/NN+ㄴ/JJ
뿌러	뿔/VB+어/EE
뿐	뿌/NA+ㄴ/EE|쁘/VB+운/EE|뿌/VB+ㄴ/EE|뿔/VB+ㄴ/EE|아/EE+뿌/VB+ㄴ/EE+이/VB
뿔	뿌/VB+ㄹ/EE
뿟	뿌/VB+ㅅ/EE
뿠	뿌/VB+았/EE
쁜	쁘/VB+ㄴ/EE|쁘/VB+ㄴ/EE+이/VB
쁜한	쁘/VB+ㄴ/EE+하/XV+ㄴ/EE
쁜해	쁘/VB+ㄴ/EE+하/XV+아/EE
쁠	쁘/VB+ㄹ/EE+이/VB|쁘/VB+ㄹ/EE
쁠건	쁘/VB+ㄹ/EE+것/NN+ㄴ/JJ
쁠텐	쁘/VB+ㄹ/EE+터/NN+이/VB+ㄴ/EE
쁨	쁘/VB+ㅁ/EE
쁩	쁘/VB+ㅂ/EE
삔	삐/NN+이/VB+ㄴ/EE|삐/VB+ㄴ/EE
삘	삐/VB+ㄹ/EE
사	살/VB|못/MA|싸/NN|살이/VB|지/NN|상/NN
사건	살/VB+것/NN+이/VB+ㄴ/EE
사게	살/VB+것/NN+이/JJ
사세	살/VB+시/EE+어/EE
사셔	살/VB+시/EE+어/EE
사셨	살/VB+시/EE+었/EE
사신	살/VB+시/EE+ㄴ/EE
사실	살/VB+시/EE+ㄹ/EE
사십	살/VB+시/EE+ㅂ/EE
사진	살/VB+지/EE+ㄴ/JJ
사질	살/VB+지/EE+ㄹ/JJ
산	살/VB+ㄹ/EE|사/VB+ㄴ/EE|살/VB+ㄴ/EE|사/NN+ㄴ/JJ
산’	살/VB+ㄴ/EE+'/SY
산’게	살/VB+ㄴ/EE+'/SY+것/NN+이/JJ
산거	살/VB+ㄴ/EE+것/NN+이/VB
산게	살/VB+ㄴ/EE+것/NN+이/JJ
산단	사/VB+ㄴ/EE
산답	살/VB+ㄴ/EE
산댔	살/VB+ㄴ/EE+다/EE+하/VB+았/EE|사/VB+ㄴ/EE+다/EE+하/VB+았/EE
산본	사/NN+이/VB+ㄴ/EE+보/VB+ㄴ/EE
산인	상/NN+이/VB+ㄴ/EE
산잖	사/VB+ㄴ/EE+지/EE+않/VB
살	사/VB+ㄹ/EE|못/MA|사/NN+ㄹ/JJ|사/NN+이/VB+ㄹ/EE
살라	사르/VB+아/EE
살랐	사르/VB+았/EE
살렀	사르/VB+었/EE
살봐	사/VB+ㄹ/EE+보/VB+아/EE
살살	사/VB+ㄹ/EE+사/VB+ㄹ/EE
살테	사/VB+ㄹ/EE+터/NN+이/VB
살한	사/VB+ㄹ/EE+하/XV+ㄴ/EE
삶	살/VB+ㅁ/EE
삽	사/VB+ㅂ/EE|사/NN+이/VB+ㅂ/EE|살/VB+ㅂ/EE
삿	사/NN
샀	사/VB+았/EE
상	성/NN
새	생/NN
샌	새/MA+이/VB+ㄴ/EE|새/NN+ㄴ/JJ|새/VB+ㄴ/EE|새/NN+ㄴ/EE|새/NN+이/VB+ㄴ/EE
샐	새/VB+ㄹ/EE|새/NN+ㄹ/EE|새/NN+ㄹ/JJ|새/VB+ㄹ/EE+이/VB
샐봐	새/VB+ㄹ/EE+보/VB+아/EE
샘	새/VB+ㅁ/EE
샙	새/VB+ㅂ/EE|새/NN+이/VB+ㅂ/EE
샜	새/VB+었/EE
샤	시/EE+아/EE
샬	샤/EE+ㄹ/EE
샵	샤/NN+이/VB+ㅂ/EE
샷	시/EE+았/EE
서	서/VB+어/EE
서룬	섧/VB+ㄴ/EE
서리	설이/VB
서릴	설이/VB+ㄹ/EE
서버	섭/VB+어/EE
서분	섭/VB+ㄴ/EE
서우	섭/VB|섭/VB+으/EE
서운	섭/VB+ㄴ/EE|섭/VB+ㄴ/EE+이/VB|섭/VB+은/EE
서울	섭/VB+ㄹ/EE
서울게	섭/VB+ㄹ/EE+것/NN+이/JJ
서움	섭/VB+음/EE|섭/VB+ㅁ/EE
서워	섭/VB+어/EE+이/VB|섭/VB+어/EE
서워셨	섭/VB+어/EE+시/EE+었/EE
서워져	섭/VB+어/EE+지/VB+어/EE
서워졌	섭/VB+어/EE+지/VB+었/EE
서워졌세	섭/VB+어/EE+지/VB+었/EE+에/EE
서워진	섭/VB+어/EE+지/VB+ㄴ/EE
서워한	섭/VB+어/EE+하/VB+ㄴ/EE
서워했	섭/VB+어/EE+하/VB+았/EE
서웠	섭/VB+었/EE
서할	선/NN+하/XV+ㄹ/EE
석	속/NN|섞/VB
선	서/EE+ㄴ/EE|서/JJ+ㄴ/JJ
선내	서/VB+ㄴ/EE+나/NN+의/JJ
설	서/JJ+ㄹ/JJ|서/VB+ㄹ/EE
설운	섧/VB+은/EE|서럽/VB+ㄴ/EE
설워	섧/VB+어/EE|럽/VB+어/EE+서/EE|서럽/VB+어/EE
설인	서/VB+ㄹ/EE+이/VB+ㄴ/EE
설테	서/VB+ㄹ/EE+터/NN+이/VB
설한	서/VB+ㄹ/EE+하/XV+ㄴ/EE
설흔	서른/NN
섦	설/VB+ㅁ/EE
섬	설/VB+ㅁ/EE|섭/VB+ㅁ/EE|서/VB+ㅁ/EE
섭	서/NN+이/VB+ㅂ/EE|서/VB+ㅂ/EE|설/VB+ㅂ/EE|어/EE+서/EE+이/VB+ㅂ/EE|서/EE+이/VB+ㅂ/EE
섯	서/VB+ㅅ/EE|서/VB+엇/EE
섰	서/VB+었/EE
섰간	서/VB+었/EE+가/EE+ㄴ/JJ
섰세	시/EE+었/EE+시/EE+어/EE
섰습	서/VB+었/EE+ㅂ/EE
성	선/NN
세	구/NN+이/JJ+시/EE+어/EE|이/JJ+시/EE+어/EE|이/VB+시/EE+어/EE|시/EE+시/EE+어/EE|서/JJ|시/EE+어/EE+이/VB|시/VB+어/EE|새/NN|어/EE+시/EE+어/EE+이/VB|어/EE+시/EE+어/EE|아/EE+시/EE+어/EE|어/EE+시/EE+어/EE+./SY|시/EE+어/EE
세세	시/EE+어/EE+시/EE+어/EE
세였	시/EE+어/EE+이/VB+었/EE
세요	시/EE+어/EE+오/EE
세인	시/EE+어/EE+이/VB+ㄴ/EE
센	세/NN+이/VB+ㄴ/EE|세/VB+ㄴ/EE|세/NN+ㄴ/JJ|새/VB+ㄴ/EE
섾	혀/VB+었/EE
셀	세/NN+ㄹ/JJ|세/VB+ㄹ/EE|세/NN+이/VB+ㄹ/EE
셈	세/VB+ㅁ/EE
셉	세/VB+ㅂ/EE|세/NN+이/VB+ㅂ/EE
셋	세/NN
셌	시/EE+었/EE|시/VB+었/EE|세/VB+었/EE
셔	시/VB+어/EE
셔갈	시/VB+어/EE+가/VB+ㄹ/EE
셔갔	시/VB+어/EE+가/VB+았/EE
셔갖	시/EE+어/EE+가지/VB
셔냈	시/VB+어/EE+내/VB+었/EE
셔논	시/EE+어/EE+놓/VB+ㄴ/EE
셔놔	시/VB+어/EE+놓/VB+아/EE
셔댄	시/VB+어/EE+대/VB+ㄴ/EE
셔댔	시/VB+어/EE+대/VB+었/EE
셔둔	시/VB+어/EE+두/VB+ㄴ/EE
셔렸	시/VB+어/EE+리/VB+었/EE
셔린	시/VB+어/EE+리/VB+ㄴ/EE
셔릴	시/VB+어/EE+리/VB+ㄹ/EE
셔본	시/VB+어/EE+보/VB+ㄴ/EE
셔볼	시/VB+어/EE+보/VB+ㄹ/EE
셔봐	시/VB+어/EE+보/VB+아/EE
셔봤	시/VB+어/EE+보/VB+았/EE
셔서	시/EE+어/EE
셔선	시/EE+어/EE+서/EE+ㄴ/JJ|시/VB+어/EE+서/EE+ㄴ/JJ
셔여	시/VB+어/EE+이/VB+어/EE
셔온	시/VB+어/EE+오/VB+ㄴ/EE
셔올	시/VB+어/EE+오/VB+ㄹ/EE
셔와	시/VB+어/EE+오/VB+아/EE
셔왔	시/VB+어/EE+오/VB+았/EE
셔웠	시/VB+어/EE+우/VB+었/EE
셔인	시/VB+어/EE+이/VB+ㄴ/EE|시/EE+어/EE+이/VB+ㄴ/EE
셔져	시/VB+어/EE+지/VB+어/EE
셔졌	시/VB+어/EE+지/VB+었/EE
셔죠	시/EE+어/EE+지/EE+요/EE
셔준	시/VB+어/EE+주/VB+ㄴ/EE
셔줄	시/VB+어/EE+주/VB+ㄹ/EE
셔줘	시/VB+어/EE+주/VB+어/EE
셔진	시/VB+어/EE+지/VB+ㄴ/EE
셔질	시/VB+어/EE+지/VB+ㄹ/EE
셔짐	시/VB+어/EE+지/VB+ㅁ/EE
셔할	시/VB+어/EE+하/VB+ㄹ/EE
셔혀	시/VB+어/EE+히/VB+어/EE
셨	시/VB+었/EE
셨나봐	시/EE+었/EE+나/EE+보/VB+아/EE
셨넌	시/EE+었/EE+던/EE
셨댄	시/EE+었/EE+단/EE
셨랬	시/VB+었/EE+라/EE+하/VB+았/EE
셨봐	시/EE+었/EE+보/VB+아/EE
셨세	아/EE+시/EE+었/EE+시/EE+어/EE|시/EE+었/EE+시/EE+어/EE
셨인	시/EE+었/EE+이/VB+ㄴ/EE
셨잖	시/EE+었/EE+지/EE+않/VB
셨텐	시/EE+었/EE+터/NN+이/VB+ㄴ/EE
소	수/NN|서/EE|발/NN
손	소/NN+ㄴ/JJ|소/NN+이/VB+ㄴ/EE
솔	소/NN+ㄹ/JJ
솝	소/NN+이/VB+ㅂ/EE
쇄	쇠/VB
쇤	쇠/NN+ㄴ/JJ|쇠/VB+ㄴ/EE
쇳	쇠/NN
쇼	시/EE+오/EE|이/VB+시/EE+오/EE|어/EE+시/EE+오/EE|시/VB+오/EE
숀	쇼/NN+이/VB+ㄴ/EE
수	숫/VB|숙/NN|사/NN
수운	숩/VB+ㄴ/EE
수워	숩/VB+어/EE
순	수/NN+이/VB+ㄴ/EE|수/NN+이/VB+ㄴ/EE+이/VB|수/NN+ㄴ/JJ|숩/VB+ㄴ/EE|수/VB+ㄴ/EE
술	수/VB+ㄹ/EE|수/NN+ㄹ/JJ
숩	수/NN+이/VB+ㅂ/EE|수/VB+ㅂ/EE
숴	수/VB+어/EE|쉬/MA|쉬/VB+어/EE
숴낸	수/VB+어/EE+내/VB+ㄴ/EE
숴댔	수/VB+어/EE+대/VB+었/EE
숴려	수/VB+어/EE+리/VB+어/EE
숴렸	수/VB+어/EE+리/VB+었/EE
숴린	수/VB+어/EE+리/VB+ㄴ/EE
숴릴	수/VB+어/EE+리/VB+ㄹ/EE
숴진	수/VB+어/EE+지/VB+ㄴ/EE
숴질	수/VB+어/EE+ㄹ/EE+지/EE
쉈	수/VB+었/EE
쉔	쉐/VB+ㄴ/EE
쉬	쉽/VB
쉬우	쉽/VB|쉽/VB+으/EE
쉬우실	쉽/VB+시/EE+ㄹ/EE
쉬운	쉽/VB+은/EE|쉽/VB+ㄴ/EE|쉽/VB+ㄴ/EE+이/VB
쉬울	쉽/VB+을/EE|쉽/VB+ㄹ/EE
쉬움	쉽/VB+ㅁ/EE
쉬움일	쉽/VB+ㅁ/EE+이/VB+ㄹ/EE
쉬워	쉽/VB+어/EE
쉬워져	쉽/VB+어/EE+지/VB+어/EE
쉬워졌	쉽/VB+어/EE+지/VB+었/EE
쉬워진	쉽/VB+어/EE+지/VB+ㄴ/EE
쉬워질	쉽/VB+어/EE+지/VB+ㄹ/EE
쉬워한	쉽/VB+어/EE+하/VB+ㄴ/EE
쉬워합	쉽/VB+어/EE+하/VB+ㅂ/EE
쉬워했	쉽/VB+어/EE+하/VB+았/EE
쉬웠	쉽/VB+었/EE
쉰	쉬/VB+ㄴ/EE|쉽/VB+ㄴ/EE
쉴	쉬/VB+ㄹ/EE
쉼	쉬/VB+ㅁ/EE
쉽	쉬/VB+ㅂ/EE
슈	시/EE+오/EE|시/EE+유/EE|시/VB+우/EE|시/EE+우/EE
스	슬/VB
스러	슬/VB+어/EE
스러워졌	하/XV+아/EE+지/VB+었/EE
스우	습/VB+으/EE
스운	습/VB+은/EE|습/VB+ㄴ/EE
스울	습/VB+ㄹ/EE
스워	습/VB+어/EE
스워진	습/VB+어/EE+지/VB+ㄴ/EE
스워질	습/VB+어/EE+지/VB+ㄹ/EE
스워한	습/VB+어/EE+하/VB+ㄴ/EE
스워할	습/VB+어/EE+하/VB+ㄹ/EE
스웠	습/VB+었/EE
스은	습/VB+ㄴ/EE
슥	슨/MM
슨	스/NN+이/VB+ㄴ/EE|슬/VB+ㄴ/EE|스/NN+ㄴ/JJ|스/VB+ㄴ/EE
슬	스/NN+ㄹ/JJ
슬러	스르/VB+어/EE+아/EE|스르/VB+어/EE
슬러간	스르/VB+어/EE+가/VB+ㄴ/EE
슬러갈	스르/VB+어/EE+가/VB+ㄹ/EE
슬러려	스르/VB+어/EE+리/VB+어/EE
슬러봐	스르/VB+어/EE+아/EE+보/VB+아/EE
슬러세	스르/VB+어/EE+시/EE+어/EE
슬러엔	스르/VB+어/EE+에/JJ+ㄴ/JJ
슬러온	스르/VB+어/EE+오/VB+ㄴ/EE
슬러올	스르/VB+어/EE+오/VB+ㄹ/EE
슬러올라	스르/VB+어/EE+오르/VB+아/EE
슬러와	스르/VB+어/EE+오/VB+아/EE
슬러왔	스르/VB+어/EE+오/VB+았/EE
슬러져	스르/VB+어/EE+지/VB+어/EE
슬렀	스르/VB+었/EE
슴	스/VB+ㅁ/EE
습	ㅂ/EE|읍/EE|스/NN+이/VB+ㅂ/EE
시	싯/VB|십/VB+어/EE|히/MA|씨/NN
시운	쉽/VB+ㄴ/EE
신	이/VB+ㄴ/EE|시/EE+ㄴ/JJ|씨/NN+ㄴ/JJ|시/VB+ㄴ/EE|시/NN+ㄴ/JJ|시/EE+시/EE+ㄴ/EE|시/EE+이/VB+ㄴ/EE|시/MA+ㄴ/JJ|시/EE+ㄴ/EE|아/EE+시/EE+ㄴ/EE|시/VB|시/EE+ㄴ/EE+이/VB|시/MA+이/VB+ㄴ/EE|아/EE+시/VB+ㄴ/EE|어/EE+시/EE|어/EE+시/EE+ㄴ/EE|시/NN+이/VB+ㄴ/EE|시/EE|이/VB+시/EE+ㄴ/EE|이/JJ+시/EE+ㄴ/EE
신게	시/EE+ㄴ/EE+것/NN+이/VB
신댔	시/VB+시/EE+ㄴ/EE+다/EE+하/VB+았/EE|시/EE+ㄴ/EE+대/EE+었/EE|시/EE+ㄴ/EE+다/EE+하/VB+았/EE
신봐	시/EE+ㄴ/EE+보/VB+아/EE
신셨	시/EE+ㄴ/EE+시/EE+었/EE
신신립	시/EE+ㄴ/EE+시/EE+ㄴ/EE+리/VB+ㅂ/EE
신였	시/EE+ㄴ/EE+이/VB+었/EE
신잖	시/EE+ㄴ/EE+지/EE+않/VB
실	시/NN+이/VB+ㄹ/EE|시/EE+ㄹ/EE+이/VB|시/VB+ㄹ/EE|시/EE+ㄹ/EE|시/NN+ㄹ/JJ|싣/VB|싣/VB+어/EE|싣/VB+아/EE|시/VB+ㄹ/EE+이/VB|시/EE+시/EE+ㄹ/EE|아/EE+시/EE+ㄹ/EE
실간	싣가/VB+ㄴ/EE
실갈	싣가/VB+ㄹ/EE
실갔	싣가/VB+았/EE
실건	시/EE+ㄹ/EE+거/NN+ㄴ/EE
실겁	시/EE+ㄹ/EE+것/NN+이/VB+ㅂ/EE
실날라	싣나/VB+르/VB+아/EE
실날랐	싣나/VB+르/VB+았/EE
실날렀	싣나/VB+르/VB+었/EE
실낼	싣내/VB+ㄹ/EE
실냈	싣내/VB+았/EE
실렸	싣리/VB+었/EE
실를	싣르/VB+ㄹ/EE
실봐	시/VB+ㄹ/EE+보/VB+아/EE|시/EE+ㄹ/EE+보/VB+아/EE
실온	싣오/VB+ㄴ/EE
실왔	싣오/VB+았/EE
실준	싣주/VB+ㄴ/EE
실줄	싣주/VB+ㄹ/EE
실줘	싣주/VB+어/EE
실줬	싣주/VB+었/EE
실테	시/VB+ㄹ/EE+터/NN+이/VB|시/EE+ㄹ/EE+터/NN+이/VB
실텐	아/EE+시/EE+ㄹ/EE+터/NN+이/VB+ㄴ/EE
실한	시/VB+ㄹ/EE+하/XV+ㄴ/EE
심	시/EE+ㅁ/EE|십/NN|아/EE+시/EE+ㅁ/EE|슴/NN|시/VB+ㅁ/EE
심인	시/EE+ㅁ/EE+이/VB+ㄴ/EE
심입	시/EE+ㅁ/EE+이/VB+ㅂ/EE
십	시/EE+시/EE+ㅂ/EE|시/EE+ㅂ/NA|시/EE+이/VB+ㅂ/EE|어/EE+시/EE+ㅂ/EE|시/EE+ㅂ/EE+이/VB|시/EE+ㅂ/EE|아/EE+시/EE+ㅂ/EE|시/VB+ㅂ/EE|이/VB+시/EE+ㅂ/EE|하/VB+시/EE+ㅂ/EE|시/EE+ㅂ/EE+하/VB|시/NN+이/VB+ㅂ/EE|시/VB+ㅂ/EE+이/VB
십요	ㅂ/EE+시/EE+오/EE
십했	시/EE+ㅂ/EE+하/XV+았/EE
싰	시/VB+었/EE
싱	시/VB+ᆼ/EE
싸	어/EE+쌓/VB+아/EE|쌓/VB+아/EE|아/EE+쌓/VB+아/EE|쌓/VB
싸인	쌓이/VB+ㄴ/EE
싼	싸/VB+ㄴ/EE
싼걸	싸/VB+ㄴ/EE+것/NN+ㄹ/JJ
싼게	싸/VB+ㄴ/EE+것/NN+이/JJ
쌀	싸/VB+ㄹ/EE
쌀텐	싸/VB+ㄹ/EE+터/NN+이/VB+ㄴ/EE
쌈	싸/VB+ㅁ/EE
쌉	싸/VB+ㅂ/EE
쌌	싸/VB+았/EE|쌓/VB+았/EE
쌌잖	싸/VB+았/EE+지/EE+않/VB
쌌한	싸/VB+았/EE+하/VB+ㄴ/EE
쌘	쌔/VB+ㄴ/EE
쌨	쌔/VB+었/EE
써	쓰/VB+어/EE
써간	쓰/VB+어/EE+가/VB+ㄴ/EE
써갈	쓰/VB+어/EE+가/VB+ㄹ/EE
써갔	쓰/VB+어/EE+가/VB+았/EE
써긴	쓰/VB+어/EE+기/EE+ㄴ/JJ
써꼈	쓰/VB+어/EE+끼/VB+었/EE
써낀	쓰/VB+어/EE+끼/VB+ㄴ/EE
써낸	쓰/VB+어/EE+내/VB+ㄴ/EE
써낼	쓰/VB+어/EE+내/VB+ㄹ/EE
써냈	쓰/VB+어/EE+내/VB+었/EE
써놨	쓰/VB+어/EE+놓/VB+았/EE
써댄	쓰/VB+어/EE+대/VB+ㄴ/EE
써댔	쓰/VB+어/EE+대/VB+었/EE
써도	쓰/VB+어/EE
써둔	쓰/VB+어/EE+두/VB+ㄴ/EE
써래	쓰/VB+어/EE+아/EE
써러	썰/VB+어/EE
써려	쓰/VB+어/EE+리/VB+어/EE
써려간	쓰/VB+어/EE+리/VB+어/EE+가/VB+ㄴ/EE
써렸	쓰/VB+어/EE+리/VB+었/EE
써린	쓰/VB+어/EE+리/VB+ㄴ/EE
써본	쓰/VB+어/EE+보/VB+ㄴ/EE
써볼	쓰/VB+어/EE+보/VB+ㄹ/EE
써봅	쓰/VB+어/EE+보/VB+ㅂ/EE
써봐	쓰/VB+어/EE+보/VB+아/EE
써봤	쓰/VB+어/EE+보/VB+았/EE
써선	쓰/VB+어/EE+서/EE+ㄴ/JJ
써세	쓰/VB+어/EE+시/EE+어/EE
써셔	쓰/VB+어/EE+시/EE+어/EE
써셨	쓰/VB+어/EE+시/EE+었/EE
써신	쓰/VB+어/EE+시/EE+ㄴ/EE
써실	쓰/VB+어/EE+시/EE+ㄹ/EE
써십	쓰/VB+어/EE+시/EE+ㅂ/EE
써써	쓰/VB+어/EE+서/EE
써여	쓰/VB+어/EE+이/VB+어/EE
써여졌	쓰/VB+어/EE+이/VB+어/EE+지/VB+었/EE
써였	쓰/VB+어/EE+이/VB+었/EE
써온	쓰/VB+어/EE+오/VB+ㄴ/EE
써왔	쓰/VB+어/EE+오/VB+았/EE
써인	쓰/VB+어/EE+이/VB+ㄴ/EE
써일	쓰/VB+어/EE+이/VB+ㄹ/EE
써져	쓰/VB+어/EE+지/VB+어/EE+하/VB|쓰/VB+어/EE+지/VB+어/EE
써준	쓰/VB+어/EE+주/VB+ㄴ/EE
써준댔	쓰/VB+어/EE+주/VB+ㄴ/EE+다/EE+하/VB+았/EE
써줄	쓰/VB+어/EE+주/VB+ㄹ/EE
써줍	쓰/VB+어/EE+주/VB+ㅂ/EE
써줘	쓰/VB+어/EE+주/VB+어/EE
써줬	쓰/VB+어/EE+주/VB+었/EE
써진	쓰/VB+어/EE+지/VB+ㄴ/EE
써질	쓰/VB+어/EE+지/VB+ㄹ/EE|쓰/VB+어/EE+ㄹ/EE+지/EE
써한	쓰/VB+어/EE+하/VB+ㄴ/EE
써한게	쓰/VB+어/EE+하/VB+ㄴ/EE+것/NN+이/JJ
써할	쓰/VB+어/EE+하/VB+ㄹ/EE
써했	쓰/VB+어/EE+하/VB+았/EE
썬	썰/VB+ㄴ/EE|써/JJ+ㄴ/JJ
썼	쓰/VB+었/EE+이/VB|쓰/VB+었/EE|어/EE+쓰/VB+었/EE
썼…	쓰/VB+었/EE
썼곤	쓰/VB+었/EE+고/EE+ㄴ/JJ
썼봐	쓰/VB+었/EE+보/VB+아/EE
썼잖	쓰/VB+었/EE+지/EE+않/VB
썼한	쓰/VB+었/EE+하/VB+ㄴ/EE
썼해	쓰/VB+었/EE+하/VB+아/EE
쎈	쎄/VB+ㄴ/EE
쏜	쏘/VB+ㄴ/EE|쏘/VB+ㄴ/EE+이/VB
쏠	쏘/VB+ㄹ/EE
쏴	쏘/VB+아/EE
쏴댄	쏘/VB+아/EE+대/VB+ㄴ/EE
쏴댔	쏘/VB+아/EE+대/VB+었/EE
쏴린	쏘/VB+아/EE+리/VB+ㄴ/EE
쏴릴	쏘/VB+아/EE+리/VB+ㄹ/EE
쏴셔	쏘/VB+아/EE+시/EE+어/EE
쏴여	쏘/VB+아/EE+이/VB+어/EE
쏴였	쏘/VB+아/EE+았/EE
쐈	쏘/VB+았/EE
쐐	쐬/VB+어/EE
쐰	쐬/VB+ㄴ/EE
쐴	쐬/VB+ㄹ/EE
쐴봐	쐬/VB+ㄹ/EE+보/VB+아/EE
쑨	쑤/NN+이/VB+ㄴ/EE|쑤/VB+ㄴ/EE
쑬	쑤/VB+ㄹ/EE
쑵	쑤/NN+이/VB+ㅂ/EE
쒀	쑤/VB+어/EE
쒀온	쑤/VB+어/EE+오/VB+ㄴ/EE
쒔	쑤/VB+었/EE
쒼	씌우/VB+ㄴ/EE
쓰	쓸/VB|슬/VB
쓰여	씌/VB+어/EE
쓰여져	씌/VB+어/EE+지/VB+어/EE
쓰여졌	씌/VB+어/EE+지/VB+었/EE
쓰여진	씌/VB+어/EE+지/VB+ㄴ/EE
쓰여질	씌/VB+어/EE+지/VB+ㄹ/EE
쓴	쓸/VB+ㄴ/EE|쓰/VB+ㄴ/EE
쓴게	쓰/VB+ㄴ/EE+거/NN+이/JJ
쓴먼	쓰/VB+ㄴ/EE+면/EE
쓴쓴	쓰/VB+ㄴ/EE+쓰/VB+ㄴ/EE
쓴였	쓰/VB+ㄴ/EE+았/EE
쓴해	쓰/VB+ㄴ/EE+하/VB+아/EE
쓸	쓰/VB+ㄹ/EE+이/VB|쓰/VB|쓰/NN+ㄹ/JJ|쓰/VB+ㄹ/EE
쓸’	쓰/VB+ㄹ/EE+'/SY
쓸건	쓰/VB+ㄹ/EE+거/NN+이/VB+ㄴ/EE
쓸게	쓰/VB+ㄹ/EE+것/NN+이/JJ
쓸봐	쓰/VB+ㄹ/EE+보/VB+아/EE
쓸인	쓰/VB+ㄹ/EE+이/VB+ㄴ/EE
쓸테	쓰/VB+ㄹ/EE+터/NN+이/VB
쓸텐	쓰/VB+ㄹ/EE+터/NN+이/VB+ㄴ/EE
쓸한	쓰/VB+ㄹ/EE+하/XV+ㄴ/EE
쓸해	쓰/VB+ㄹ/EE+하/XV+아/EE
씀	쓰/VB+ㅁ/EE
씁	쓸/VB+ㅂ/EE|쓰/VB+ㅂ/EE
씌	쓰이/VB
씌여졌	쓰이/VB+어/EE+지/VB+었/EE
씌여진	쓰이/VB+어/EE+지/VB+ㄴ/EE
씌져	쓰이/VB+지/VB+어/EE+어/EE|쓰이/VB+지/VB+어/EE
씌졌	쓰이/VB+지/VB+었/EE|쓰이/VB+지/VB+어/EE+었/EE
씌진	쓰이/VB+지/VB+ㄴ/EE|쓰이/VB+지/VB+어/EE+ㄴ/EE
씐	씌/VB+ㄴ/EE
씨셔	씻/VB+어/EE
씬	씨/NN|씨/NN+ㄴ/JJ|씨/NN+이/VB+ㄴ/EE
씰	씨/NN+ㄹ/JJ
씹	씨/NN+이/VB+ㅂ/EE
아	알/VB+시/EE|알이/VB|들/XN|이/VB+어/EE|어/VB|다/NN|안/VB|알/VB|으/VB+어/EE|알/VB+어/EE|와/JJ|다/VB
아는	알/VB+은/EE
아마	알말/VB
아무	암/MM
아섰	알/VB+시/EE+었/EE
아세	알/VB+시/EE+어/EE
아셔	알/VB+시/EE+어/EE
아셨	알/VB+시/EE+었/EE
아셨간	알/VB+시/EE+었/EE+가/EE+ㄴ/JJ
아셨나봐	알/VB+시/EE+었/EE+나/EE+보/VB+아/EE
아쇼	알/VB+시/EE+오/EE
아슈	알/VB+시/EE+유/EE
아신	알/VB+시/EE+ㄴ/EE
아실	알/VB+시/EE+ㄹ/EE
아실테	알/VB+시/EE+ㄹ/EE+터/NN+이/VB
아실텐	알/VB+시/EE+ㄹ/EE+터/NN+이/VB+ㄴ/EE
아십	알/VB+시/EE+ㅂ/EE|알/VB+시/EE+ㅂ/EE+이/VB
아졌	이/VB+어/EE+지/VB+었/EE
아진	알/VB+지/EE+ㄴ/JJ|이/VB+어/EE+지/VB+ㄴ/EE
아했	알/VB+하/XV+았/EE|알하/VB+았/EE
안	아/NN+ㄴ/JJ|알/VB+ㄴ/EE|알/VB|인/NN|아/NN+이/VB+ㄴ/EE|않/VB
안댔	알/VB+ㄴ/EE+다/EE+하/VB+았/EE
안쟈	앉/VB+아/EE
앍	읽/VB
앎	알/VB+ㅁ/EE
앎입	알/VB+ㅁ/EE+이/VB+ㅂ/EE
암	아무/MM|아무/NN
암껏	아무/NN+것/NN
압	알/VB+ㅂ/EE|아/NN+이/VB+ㅂ/EE
압였	알/VB+ㅂ/EE+이/VB+었/EE
앗	았/EE
았	이/VB+었/EE
았겼	앗기/VB+었/EE
애	어/EE|에/JJ|계/NN|얘/NN
애한	얘/NN+하/XV+ㄴ/EE
앤	애/VB+ㄴ/EE+에/JJ|애/NN+ㄴ/JJ|애/NN+이/VB+ㄴ/EE|애/VB+ㄴ/EE|애/NN+ㄴ/EE
앨	애/NN+ㄹ/JJ|애/VB+ㄹ/EE
앰	애/VB+ㅁ/EE
앱	애/NN+이/VB+ㅂ/EE|애/VB+ㅂ/EE
앴	애/VB+았/EE|애/VB+었/EE|얗/VB+았/EE
야	아/EE|어/EE|아/NN|이/VB+아/EE+이/VB|이/VB+아/EE|아/EE+이/VB
야요	이/VB+아/EE+오/EE
야케	얗/VB+게/EE
얀	얗/VB+ㄴ/EE|얗/VB+ㄴ/EE+이/VB|야/NN+이/VB+ㄴ/EE
얄	얗/VB+ㄹ/EE|아/EE+야/EE+하/VB+ㄹ/EE|야/EE+하/VB+ㄹ/EE
얐	았/EE
얘	이/VB+예/EE|얗/VB+어/EE|얗/VB+아/EE
얘진	얗/VB+아/EE+지/VB+ㄴ/EE
얘한	이야/NN+하/XV+ㄴ/EE
얜	얘/NN+ㄴ/JJ|얘/IC+ㄴ/JJ
얬	얗/VB+았/EE
어	아/EE|러/MA|엇/NN+이/VB|얼/VB|아/VB|아/NN|엇/NN|었/EE
어다	달/VB
어도	어/EE
어둔	두/VB+ㄴ/EE
어랬	라/EE+하/VB+았/EE
어렸	리/VB+었/EE
어린	아/EE+리/VB+ㄴ/EE
어릴	리/VB+ㄹ/EE
어립	리/VB+ㅂ/EE
어섰	서/VB+었/EE
어요	엇/NN+이/VB+오/EE
어인	엇/NN+이이/VB+ㄴ/EE
어졌	지/VB+었/EE|짓/VB+어/EE+었/EE
어졌한	짓/VB+어/EE+었/EE+하/VB+ㄴ/EE
어진	짓/VB+어/EE+ㄴ/EE|지/EE+ㄴ/JJ|짓/VB+어/EE+ㄴ/EE+./SY
어질	짓/VB+어/EE+ㄹ/EE|지/EE+ㄹ/JJ
어한	엉/MA+하/XV+ㄴ/EE
어할	엇/NN+이하/VB+ㄹ/EE
언	원/NN|얼/VB+ㄴ/EE|엇/NN+이/VB+ㄴ/EE|엇/NN+이/VB+ㄴ/EE+이/VB|어/NN+이/VB+ㄴ/EE
언갈	엇/NN+이/VB+ㄴ/EE+가/EE+ㄹ/JJ
언인	원/NN+이/VB+ㄴ/EE|엇/NN+이/VB+ㄴ/EE
얼	엇/NN+이/VB+ㄹ/EE|엇/NN|엇/NN+ㄹ/JJ
얼거	얽/VB+어/EE
얼러	어르/VB+어/EE
얼러준	어르/VB+어/EE+주/VB+ㄴ/EE
얼렀	어르/VB+었/EE
얼할	엇/NN+ㄹ/JJ+하/VB+ㄹ/EE
얼해	엇/NN+ㄹ/JJ+하/VB+아/EE
업	없/VB|엇/NN+이/VB+ㅂ/EE
업셔	없/VB+어/EE
엇	었/EE
었	았/EE|없/VB
었인	엇/NN+이/VB+ㄴ/EE
었잖	짓/VB+었/EE+않/VB|지/EE+않/VB
에	예/NN+이/VB|이/VB+어/EE|엇/NN+이/VB|엇/NN+이/JJ|예/MA|데/NN|예/NN|어/EE|께/XN+로/JJ|의/JJ|이/VB+예/EE|데/MA|예/EE
엔	이/VB+에/JJ+ㄴ/JJ|에/JJ+이/VB+ㄴ/EE|에/NN+ㄴ/JJ|에/EE+ㄴ/JJ|에/JJ+는/JJ|에/JJ+ㄴ/JJ
엔입	에/JJ+ㄴ/JJ+이/VB+ㅂ/EE
엘	에/JJ+ㄹ/JJ
엣	옛/NN
여	이/XN+어/EE|이/VB+어/EE
여간	이/VB+어/EE+가/VB+ㄴ/EE|아/EE+가/VB+ㄴ/EE
여갈	이/VB+어/EE+가/VB+ㄹ/EE|아/EE+가/VB+ㄹ/EE
여감	이/VB+어/EE+가/VB+ㅁ/EE
여갔	아/EE+가/VB+았/EE|이/VB+어/EE+가/VB+았/EE
여게	열/VB+것/NN+이/JJ
여겨	이/VB+어/EE+기/VB+어/EE
여겼	이/VB+어/EE+기/VB+었/EE
여긴	이/VB+어/EE+기/VB+ㄴ/EE|이/VB+어/EE+기/EE+ㄴ/JJ
여길	이/VB+어/EE+기/EE+ㄹ/JJ
여난	이/VB+어/EE+나/VB+ㄴ/EE
여날	이/VB+어/EE+나/VB+ㄹ/EE
여났	이/VB+어/EE+나/VB+았/EE
여낸	이/VB+어/EE+내/VB+ㄴ/EE
여낼	이/VB+어/EE+내/VB+ㄹ/EE
여냈	이/VB+어/EE+내/VB+었/EE
여노	이/VB+어/EE+놓/VB+으/EE
여논	이/VB+어/EE+놓/VB+ㄴ/EE
여놔	이/VB+어/EE+놓/VB+아/EE
여놨	이/VB+어/EE+놓/VB+았/EE
여다	아/EE+달/VB|이/VB+어/EE+달/VB
여댄	이/VB+어/EE+대/VB+ㄴ/EE
여댔	이/VB+어/EE+대/VB+었/EE
여둔	이/VB+어/EE+두/VB+ㄴ/EE|아/EE+두/VB+ㄴ/EE
여뒀	이/VB+어/EE+두/VB+었/EE
여드	어/EE+들/VB|이/VB+어/EE+들/VB
여든	이/VB+어/EE+들/VB+ㄴ/EE|어들/VB+ㄴ/EE
여듭	이/VB+어/EE+들/VB+ㅂ/EE
여러운	어렵/VB+ㄴ/EE
여러울	어렵/VB+ㄹ/EE
여럽	어렵/VB
여려	이/VB+어/EE+리/VB+어/EE+하/VB|이/VB+어/EE+리/VB+어/EE
여려준	이/VB+어/EE+리/VB+어/EE+주/VB+ㄴ/EE
여렸	아/EE+리/VB+었/EE|이/VB+어/EE+리/VB|이/VB+어/EE+리/VB+었/EE
여린	이/VB+어/EE+리/VB+ㄴ/EE
여릴	이/VB+어/EE+리/VB+ㄹ/EE
여립	이/VB+어/EE+리/VB+ㅂ/EE
여만	이/VB+어/EE+말/VB+ㄴ/EE
여본	아/EE+보/VB+ㄴ/EE|이/VB+어/EE+보/VB+ㄴ/EE
여볼	이/VB+어/EE+보/VB+ㄹ/EE|아/EE+보/VB+ㄹ/EE
여봄	이/VB+어/EE+보/VB+ㅁ/EE
여봐	이/VB+어/EE+보/VB+아/EE
여봤	이/VB+어/EE+보/VB+았/EE
여불	이/VB+어/EE+부/VB+ㄹ/EE
여사	이/VB+어/EE+살/VB
여산	이/VB+어/EE+살/VB+ㄴ/EE
여선	이/VB+어/EE+서/VB+ㄴ/EE
여섰	이/VB+어/EE+서/VB+었/EE
여세	아/EE+시/EE+어/EE|이/VB+어/EE+시/EE+어/EE
여셨	이/VB+어/EE+시/VB+었/EE|열/VB+시/EE+었/EE|이/VB+어/EE+시/EE+었/EE
여신	이/VB+어/EE+시/EE+ㄴ/EE
여실	열/VB+시/EE+ㄹ/EE|이/VB+어/EE+시/VB+ㄹ/EE
여쓸	이/VB+어/EE+쓰/VB+ㄹ/EE
여였	이/VB+어/EE+이/VB+었/EE|아/EE+이/VB+었/EE
여온	아/EE+오/VB+ㄴ/EE|이/VB+어/EE+오/VB+ㄴ/EE
여올	이/VB+어/EE+오/VB+ㄹ/EE
여옴	아/EE+오/VB+ㅁ/EE
여와	이/VB+어/EE+오/VB+아/EE
여왔	이/VB+어/EE+오/VB+았/EE
여우	엽/VB
여우셨	엽/VB+시/EE+었/EE
여운	엾/VB+ㄴ/EE|엽/VB+ㄴ/EE
여울	엽/VB+ㄹ/EE
여움	엽/VB+ㅁ/EE
여웁	엽/VB
여워	이/VB+어/EE+우/VB+어/EE|엽/VB+어/EE
여워져	엽/VB+어/EE+지/VB+어/EE
여워졌	엽/VB+어/EE+지/VB+었/EE
여워질	엽/VB+어/EE+지/VB+ㄹ/EE
여워할	엽/VB+어/EE+하/VB+ㄹ/EE
여워해	엽/VB+아/EE+하/VB+아/EE|엽/VB+어/EE+하/VB+아/EE
여워했	엽/VB+어/EE+하/VB+았/EE
여웠	엽/VB+었/EE
여은	엽/VB+ㄴ/EE
여인	아/EE+이/VB+ㄴ/EE|이/VB+어/EE+이/VB+ㄴ/EE
여일	이/VB+어/EE+이/VB+ㄹ/EE
여입	아/EE+이/VB+ㅂ/EE
여져	이/VB+어/EE+지/VB+어/EE|아/EE+지/VB+어/EE
여져간	이/VB+어/EE+지/VB+어/EE+가/VB+ㄴ/EE
여져온	이/VB+어/EE+지/VB+어/EE+오/VB+ㄴ/EE
여져왔	이/VB+어/EE+지/VB+어/EE+오/VB+았/EE
여졌	아/EE+지/VB+었/EE|어/EE+지/VB+었/EE|이/VB+어/EE+지/VB+었/EE
여졌달	이/VB+어/EE+지/VB+었/EE+다/EE+ㄹ/EE
여준	어/EE+주/VB+ㄴ/EE|이/VB+어/EE+주/VB+ㄴ/EE|아/EE+주/VB+ㄴ/EE
여줄	이/VB+어/EE+주/VB+ㄹ/EE
여줄테	이/VB+어/EE+주/VB+ㄹ/EE+터/NN+이/VB
여줄한	이/VB+어/EE+주/VB+ㄹ/EE+하/XV+ㄴ/EE
여줌	이/VB+어/EE+주/VB+ㅁ/EE
여줍	이/VB+어/EE+주/VB+ㅂ/EE
여줘	어/EE+주/VB+어/EE|이/VB+어/EE+주/VB+어/EE+하/VB|이/VB+어/EE+주/VB+어/EE
여줘봐	이/VB+어/EE+주/VB+어/EE+보/VB+아/EE
여줬	이/VB+어/EE+주/VB+었/EE
여줬본	이/VB+어/EE+주/VB+었/EE+보/VB+ㄴ/EE
여줬잖	이/VB+어/EE+주/VB+었/EE+지/EE+않/VB
여진	어/EE+지/VB+ㄴ/EE|아/EE+지/VB+ㄴ/EE|이/VB+어/EE+지/VB+ㄴ/EE
여질	이/VB+어/EE+지/VB+ㄹ/EE
여짐	이/VB+어/EE+지/VB+ㅁ/EE
여집	이/VB+어/EE+지/VB+ㅂ/EE
여파	이/VB+어/EE+팔/VB
여할	이/VB+어/EE+하/VB+ㄹ/EE
연	옇/VB+ㄴ/EE|여/XN+ㄴ/JJ|열/VB+ㄴ/EE
열	얼/NN|여/XN+ㄹ/JJ
염	열/NN|엽/VB+ㅁ/EE
엽	열/VB+ㅂ/EE
엿	이/VB+었/EE
였	이/VB+었/EE
였간	이/VB+었/EE+가/EE+ㄴ/JJ
였게	이/VB+었/EE+것/NN+이/JJ
였만	았/EE+말/VB+ㄴ/EE
였봅	이/VB+었/EE+보/VB+ㅂ/EE
였봐	이/VB+었/EE+보/VB+아/EE
였쁜	았/EE+쁘/VB+ㄴ/EE
였셨	이/VB+었/EE+시/VB+었/EE
였여	았/EE+아/EE
였은	았/EE+을/EE
였이	이/VB+었/EE+니/EE
였인	이/VB+었/EE+이/VB+ㄴ/EE
였일	았/EE+이/VB+ㄹ/EE
였잖	이/VB+었/EE+지/EE+않/VB
였텐	이/VB+었/EE+터/NN+이/VB+ㄴ/EE
였한	았/EE+하/XV+ㄴ/EE|이/VB+었/EE+하/VB+ㄴ/EE|았/EE+하/VB+ㄴ/EE
였할	이/VB+었/EE+하/VB+ㄹ/EE
예	여기/NN+에/JJ
예져	얘지/VB+어/EE
옌	예/MA+이/VB+ㄴ/EE
옜	옇/VB+었/EE
오	로/JJ|올/NN|요/EE|소/EE|옵/EE
오신	옵/EE+시/EE+ㄴ/EE
온	오/VB+ㄴ/EE
온간	오/VB+ㄴ/EE+가/VB+ㄴ/EE
온간집	오/VB+ㄴ/EE+가/VB+ㄴ/EE+지/VB+ㅂ/EE
온거	오/VB+ㄴ/EE+것/NN+이/VB
온건	오/VB+ㄴ/EE+것/NN+ㄴ/EE
온겁	오/VB+ㄴ/EE+것/NN+이/VB+ㅂ/EE
온게	오/VB+아/EE+라/EE
온겨	오/VB+아/EE+라/EE
온고	오/VB+아/EE+라/EE
온나	오/VB+아/EE+라/EE
온다	오/VB+아/EE+라/EE
온단	오/VB+ㄴ/EE+다/EE+하/VB+ㄴ/EE
온댔	오/VB+ㄴ/EE+다/EE+하/VB+았/EE
온댜	오/VB+아/EE+라/EE
온데간	오/VB+ㄴ/EE+ㄴ/EE+데/NN+가/JJ
온런	오/VB+ㄴ/EE+럽/XV+ㄴ/EE
온인	오/VB+ㄴ/EE+이/VB+ㄴ/EE
온지	오/VB+아/EE+라/EE
온한	오/VB+ㄴ/EE+하/XV+ㄴ/EE
온해	오/VB+ㄴ/EE+하/VB+아/EE
올	오/VB+ㄹ/EE
올갈	오/VB+ㄹ/EE+가/VB+ㄹ/EE
올거	오/VB+ㄹ/EE+것/NN+이/VB
올건	오/VB+ㄹ/EE+것/NN+이/VB+ㄴ/EE
올걸	오/VB+ㄹ/EE+것/NN+이/VB+ㄹ/EE
올게	오/VB+ㄹ/EE+것/NN+이/JJ
올깁	오/VB+ㄹ/EE+기/NN+이/VB+ㅂ/EE
올꺼	오/VB+ㄹ/EE+거/NN+이/VB
올낀	오/VB+ㄹ/EE+끼/NN+이/VB+ㄴ/EE
올땐	오/VB+ㄹ/EE+때/NN+ㄴ/JJ
올라	아/EE+오르/VB+아/EE|오르/VB+아/EE+아/EE|오르/VB+아/EE|오르/VB+아/EE+이/VB
올라간	오르/VB+아/EE+가/VB|오르/VB+아/EE+가/VB+ㄴ/EE
올라갔	오르/VB+아/EE+가/VB+았/EE
올라녔	오르/VB+아/EE+니/VB+었/EE
올라는	오르/VB+아/EE
올라닐	오르/VB+아/EE+니/VB+ㄹ/EE
올라봐	오르/VB+아/EE+보/VB+아/EE
올라봤	오르/VB+아/EE+보/VB+았/EE
올라섰	오르/VB+아/EE+서/VB+었/EE
올라온	오르/VB+아/EE+오/VB+ㄴ/EE
올라올	오르/VB+아/EE+오/VB+ㄹ/EE
올라와	오르/VB+아/EE+오/VB+아/EE
올라왔	오르/VB+아/EE+오/VB+았/EE
올라졌	오르/VB+아/EE+지/VB+었/EE
올라줄	오르/VB+아/EE+주/VB+ㄹ/EE
올랐	오르/VB+았/EE+다/EE|오르/VB+았/EE+하/VB|오르/VB+았/EE|아/EE+오르/VB+았/EE
올랐간	오르/VB+았/EE+가/EE+ㄴ/JJ
올랐세	오르/VB+았/EE+시/EE+어/EE
올랐요	오르/VB+았/EE+이/VB+오/EE
올러	오르/VB+어/EE
올봐	오/VB+ㄹ/EE+보/VB+아/EE
올봐라	오르/VB+아/EE+보/VB+아/EE
올였	오/VB+ㄹ/EE+이/VB+었/EE
올테	오/VB+ㄹ/EE+터/NN+이/VB
올텐	오/VB+ㄹ/EE+터/NN+이/VB+ㄴ/EE
올한	오/VB+ㄹ/EE+하/XV+ㄴ/EE|오/VB+ㄹ/EE+하/VB+ㄴ/EE
옴	아/EE+오/VB+ㅁ/EE|오/VB+ㅁ/EE
옴남	오/VB+ㅁ/EE+나/VB+ㅁ/EE
옴한	오/VB+ㅁ/EE+하/XV+ㄴ/EE|오/VB+ㅁ/EE+하/VB+ㄴ/EE
옵	오/EE+ㅂ/EE|오/VB+ㅂ/EE|오/NN+이/VB+ㅂ/EE
옹	오/VB+ᆼ/EE
와	오/EE+아/EE|어/EE+오/VB+아/EE|과/JJ|아/EE+오/VB+아/EE+하/VB|우/VB+아/EE|오/VB+아/EE+이/VB|아/EE+오/VB+아/EE|오/VB+아/EE+하/VB|오/VB+아/EE
와간	오/VB+아/EE+가/VB+ㄴ/EE
와긴	오/VB+아/EE+기/EE+ㄴ/JJ
와녀	오/VB+아/EE+니/VB+어/EE
와다	오/VB+아/EE+달이/VB
와라	온/MM+힘/NN
와려	오/VB+아/EE+리/VB+어/EE
와렸	오리/VB+었/EE|오/VB+아/EE+리/VB+었/EE
와렸잖	오/VB+아/EE+리/VB+었/EE+지/EE+않/VB
와린	오/VB+아/EE+리/VB+ㄴ/EE|오/VB+아/EE+리/VB
와릴	오/VB+아/EE+리/VB+ㄹ/EE
와립	오/VB+아/EE+리/VB+ㅂ/EE
와바	오/VB+아/EE+보/VB+아/EE
와본	오/VB+아/EE+보/VB+ㄴ/EE
와볼	오/VB+아/EE+보/VB+ㄹ/EE
와봐	오/VB+아/EE+보/VB+아/EE
와봤	오/VB+아/EE+보/VB+았/EE
와분	오/VB+아/EE+부/VB+ㄴ/EE
와서	아/EE+오/VB
와선	오/VB+아/EE+서/EE+ㄴ/JJ
와세	오/VB+아/EE+시/EE+어/EE
와셔	오/VB+아/EE+시/EE+어/EE
와셨	오/VB+아/EE+시/EE+었/EE
와신	오/VB+아/EE+시/EE+ㄴ/EE
와십	오/VB+아/EE+시/EE+ㅂ/EE
와였	오/VB+아/EE+이/VB+었/EE|오/VB+아/EE+었/EE
와와	오/VB+아/EE+오/VB+아/EE
와와와	오/VB+아/EE+오/VB+아/EE+오/VB+아/EE
와인	오/VB+아/EE+이/VB+ㄴ/EE
와일	오/VB+아/EE+이/VB+ㄹ/EE
와준	오/VB+아/EE+주/VB+ㄴ/EE
와줄	오/VB+아/EE+주/VB+ㄹ/EE
와줘	오/VB+아/EE+주/VB+어/EE+하/VB|오/VB+아/EE+주/VB+어/EE
와줬	오/VB+아/EE+주/VB+었/EE
와질	오/VB+아/EE+지/EE+ㄹ/JJ
와한	오/VB+아/EE+하/XV+ㄴ/EE
와했	오/VB+아/EE+하/VB+았/EE
완	와/JJ+ㄴ/JJ
왓	오/VB+앗/EE|오/VB+았/EE
왔	오/VB+았/EE+하/VB|오/VB+았/EE+이/VB|았/EE|으오/VB+았/EE|아/EE+오/VB+았/EE|오/VB+았/EE|어/EE+오/VB+았/EE
왔간	오/VB+았/EE+가/VB+ㄴ/EE|오/VB+았/EE+가/EE+ㄴ/JJ
왔갈	오/VB+았/EE+가/VB+ㄹ/EE
왔갔	오/VB+았/EE+가/VB+았/EE
왔갔간	오/VB+았/EE+가/VB+았/EE+가/EE+ㄴ/JJ
왔갔신	오/VB+았/EE+가/VB+았/EE+시/EE+ㄴ/EE
왔갔여	오/VB+았/EE+가/VB+았/EE+아/EE
왔갔한	오/VB+았/EE+가/VB+았/EE+하/VB+ㄴ/EE
왔갔할	오/VB+았/EE+가/VB+았/EE+하/VB+ㄹ/EE
왔갔합	오/VB+았/EE+가/VB+았/EE+하/VB+ㅂ/EE
왔갔해	오/VB+았/EE+가/VB+았/EE+하/VB+아/EE
왔갔해본	오/VB+았/EE+가/VB+았/EE+하/XV+아/EE+보/VB+ㄴ/EE
왔갔했	오/VB+았/EE+가/VB+았/EE+하/VB+았/EE
왔갔했잖	오/VB+았/EE+가/VB+았/EE+하/VB+았/EE+지/EE+않/VB
왔게	오/VB+았/EE+것/NN+이/JJ
왔깨	오/VB+았/EE+께/EE
왔느	오/VB+았/EE+늘/VB
왔다	오/VB+았/EE
왔댔	오/VB+았/EE+다/EE+하/VB+았/EE
왔던	오/VB+았/EE
왔땐	오/VB+았/EE+때/NN+ㄴ/JJ
왔랬	오/VB+았/EE+라/EE+하/VB+았/EE
왔본	오/VB+았/EE+보/VB+ㄴ/EE
왔세	오/VB+았/EE+시/EE+어/EE
왔여	오/VB+았/EE+아/EE
왔였	오/VB+았/EE+이/VB+었/EE
왔잖	오/VB+았/EE+지/EE+않/VB
왔한	오/VB+았/EE+하/VB+ㄴ/EE
왔해	오/VB+았/EE+하/VB+아/EE
왕	황/NN
왠	왜/MA+이/VB+ㄴ/EE|웬/MM
왠인	웬/MM+이/VB+ㄴ/EE
왼	외/VB+ㄴ/EE
욀	외/VB+ㄹ/EE
요	이/VB+오/EE|아/EE+이/VB+오/EE|이/JJ+오/EE|구/NN+이/VB+오/EE|이/VB+오/EE+이/VB|ㄹ/EE+이/VB+오/EE|오/EE|됴/NN
요요	이/VB+오/EE+이/VB+오/EE
욘	요/NN+ㄴ/JJ
우	유/NN|울/VB|울/NN|웃/NN
우로운	유/NN+롭/XV+ㄴ/EE
우마	울말/VB+아/EE
우세	울/VB+시/EE+어/EE
우셔	울/VB+시/EE+어/EE
우셨	울/VB+시/EE+었/EE
우신	울/VB+시/EE+ㄴ/EE
우실	울/VB+시/EE+ㄹ/EE
우십	울/VB+시/EE+ㅂ/EE
욱	육/NN
운	우/VB+ㄴ/EE+이/VB|우/VB+ㄴ/EE|원/NN|우/MA+ㄴ/JJ|우/NN+ㄴ/JJ|울/VB+ㄴ/EE+이/VB|우/NN+이/VB+ㄴ/EE|럽/XV+은/EE|울/VB+ㄴ/EE
운가봐	갑/VB+ㄴ/EE+보/VB+아/EE
운데다	답/VB+ㄴ/EE+데/NN+에/JJ
운여	우/VB+ㄴ/EE+아/EE
울	우리/NN|우/VB+ㄹ/EE|우/VB+ㄹ/EE+ㄹ/EE|을/JJ|우/NN+ㄹ/JJ
울게	우/VB+ㄹ/EE+것/NN+이/JJ
울땐	우/VB+ㄹ/EE+때/NN+ㄴ/JJ
울러	우르/VB+어/EE
울러져	우르/VB+어/EE+지/VB+어/EE
울렀	우르/VB+었/EE
울봐	우/VB+ㄹ/EE+보/VB+아/EE
울인	우/VB+ㄹ/EE+이/VB+ㄴ/EE
울져	우러/VB+지/VB
울테	우/VB+ㄹ/EE+터/NN+이/VB
울한	우/VB+ㄹ/EE+하/XV+ㄴ/EE
움	우/VB+ㅁ/EE
움일	우/VB+ㅁ/EE+이/VB+ㄹ/EE
웁	울/VB+ㅂ/EE|우/NN+ㅂ/EE|우/NN+이/VB+ㅂ/EE|우/VB+ㅂ/EE
워	우/VB+어/EE+ㄹ/EE|우/NA+어/EE|우/VB+어/EE|어/VB|우/VB+어/EE+이/VB|어/EE|우/VB+어/EE+하/VB|우/VB+어/EE+이/VB+라/EE|웁/VB+어/EE|우/VB+어/EE+어/EE|우/VB+어/EE+아/EE
워간	우/VB+어/EE+가/VB+ㄴ/EE
워갈	우/VB+어/EE+가/VB+ㄹ/EE
워감	우/VB+어/EE+가/VB+ㅁ/EE
워갑	우/VB+어/EE+가/VB+ㅂ/EE
워갔	우/VB+어/EE+가/VB+았/EE
워길	우/VB+어/EE+기/EE+ㄹ/JJ|우/VB+어/EE+기/EE+를/JJ
워낸	우/VB+어/EE+내/VB+ㄴ/EE
워낼	우/VB+어/EE+내/VB+ㄹ/EE
워냅	우/VB+어/EE+내/VB+ㅂ/EE
워냈	우/VB+어/EE+내/VB+었/EE|우/VB+어/EE+내/VB+았/EE
워논	우/VB+어/EE+놓/VB+ㄴ/EE
워놔	우/VB+어/EE+놓/VB+아/EE
워놨	우/VB+어/EE+놓/VB+았/EE
워다	우/VB+어/EE+달/VB
워댄	우/VB+어/EE+대/VB+ㄴ/EE
워댔	우/VB+어/EE+대/VB+었/EE
워둔	우/VB+어/EE+두/VB+ㄴ/EE
워둘	우/VB+어/EE+두/VB+ㄹ/EE
워둠	우/VB+어/EE+두/VB+ㅁ/EE
워둡	우/VB+어/EE+두/VB+ㅂ/EE
워둬	우/VB+어/EE+두/VB+어/EE
워뒀	우/VB+어/EE+두/VB+었/EE
워든	우/VB+어/EE+들/VB+ㄴ/EE
워려	우/VB+어/EE+리/VB+어/EE
워렸	우/VB+어/EE+리/VB+었/EE
워린	우/VB+어/EE+리/VB+ㄴ/EE
워릴	우/VB+어/EE+리/VB+ㄹ/EE
워림	우/VB+어/EE+리/VB+ㅁ/EE
워무	우/VB+어/EE+물/VB
워문	우/VB+어/EE+물/VB+ㄴ/EE
워본	우/VB+어/EE+보/VB+ㄴ/EE
워볼	우/VB+어/EE+보/VB+ㄹ/EE
워봅	우/VB+어/EE+보/VB+ㅂ/EE
워봐	우/VB+어/EE+보/VB+아/EE
워봤	우/VB+어/EE+보/VB+았/EE
워서	섭/VB+어/EE+이/VB|섭/VB+어/EE
워서였	섭/VB+어/EE+이/VB+었/EE
워선	우/VB+어/EE+서/EE+ㄴ/JJ|섭/VB+어/EE+이/VB+ㄴ/EE
워세	우/VB+어/EE+시/EE+어/EE
워셨	우/VB+어/EE+시/EE+었/EE
워신	우/VB+어/EE+시/EE+ㄴ/EE
워실	우/VB+어/EE+시/EE+ㄹ/EE
워십	우/VB+어/EE+시/EE+ㅂ/EE
워엔	우/VB+어/EE+에/JJ+ㄴ/JJ
워여	우/VB+어/EE+이/VB+어/EE
워였	우/VB+어/EE+이/VB+었/EE
워온	우/VB+어/EE+오/VB+ㄴ/EE
워올	우/VB+어/EE+오/VB+ㄹ/EE
워와	우/VB+어/EE+오/VB+아/EE+하/VB
워왔	우/VB+어/EE+오/VB+았/EE
워인	우/VB+어/EE+이/VB+ㄴ/EE
워일	우/VB+어/EE+이/VB+ㄹ/EE
워잖	우/VB+어/EE+지/EE+않/VB
워져	우/VB+어/EE+지/VB+어/EE|우/VB+어/EE+지/VB+어/EE+아/EE|짓/VB+어/EE+어/EE
워져갔	우/VB+어/EE+지/VB+어/EE+가/VB+았/EE|갑/VB+어/EE+지/VB+어/EE+았/EE
워져렸	우/VB+어/EE+지/VB+어/EE+리/VB+었/EE
워져린	우/VB+어/EE+지/VB+어/EE+리/VB+ㄴ/EE
워져릴	우/VB+어/EE+지/VB+어/EE+리/VB+ㄹ/EE
워졌	우/VB+어/EE+지/VB+었/EE
워준	우/VB+어/EE+주/VB+ㄴ/EE
워줄	줍/VB+어/EE+ㄹ/EE|우/VB+어/EE+주/VB+ㄹ/EE
워줌	우/VB+어/EE+주/VB+ㅁ/EE
워줍	우/VB+어/EE+주/VB+ㅂ/EE
워줘	우/VB+어/EE+주/VB+어/EE
워줘봤	우/VB+어/EE+주/VB+어/EE+보/VB+았/EE
워줬	우/VB+어/EE+주/VB+었/EE
워진	우/VB+어/EE+지/VB+ㄴ/EE|럽/VB+어/EE+지/VB+ㄴ/EE|어/EE+지/VB+ㄴ/EE|우/VB+어/EE+지/EE+ㄴ/JJ|짓/VB+어/EE+ㄴ/EE
워질	우/VB+어/EE+지/VB+ㄹ/EE|우/VB+어/EE+지/EE+ㄹ/JJ
워짐	우/VB+어/EE+지/VB+ㅁ/EE
워쩌	어/MA+찌/MA+하/XV
워칠	우/VB+어/EE+치/VB+ㄹ/EE
워파	우/VB+어/EE+팔/VB
워한	우/VB+어/EE+하/VB+ㄴ/EE
워할	우/VB+어/EE+하/VB+ㄹ/EE
워해	우/VB+어/EE+하/VB+아/EE
워했	우/VB+어/EE+하/VB+았/EE
원	업/NN
웠	우/VB+었/EE+이/VB|우/VB+었/EE|었/EE|우/VB+었/EE+아/EE
웠간	우/VB+었/EE+가/EE+ㄴ/JJ
웠옵	우/VB+었/EE+오/EE+ㅂ/EE
웠잖	우/VB+었/EE+지/EE+않/VB
웬	왠/MM
웬여	왠/MM+어/EE
위져	우/VB+어/EE+지/VB+어/EE
윈	의/VB+ㄴ/EE+에/JJ|위/NN+ㄴ/JJ|의/VB+ㄴ/EE|위/VB+ㄴ/EE|위/NN+이/VB+ㄴ/EE
윌	위/VB+ㄹ/EE|위/NN+이/VB+ㄹ/EE|위/NN+ㄹ/JJ
윔	위/VB+ㅁ/EE
윕	위/NN+ㅂ/EE|위/NN+이/VB+ㅂ/EE
윗	위/NN
유	이/VB+우/EE
윤	유/NN+이/VB+ㄴ/EE|유/NN+ㄴ/JJ
율	유/NN+ㄹ/JJ
으량	을/EE+양/NN
으섯	읏/VB+었/EE
으했	그/MA+하/XV+았/EE
은	ㄴ/EE|으/VB+ㄴ/EE|을/EE|아/EE+으/VB+ㄴ/EE|는/JJ
은대	으/VB+ㄴ/EE+다/EE+하/VB+아/EE
을	으/VB+ㄹ/EE|으/EE+ㄹ/EE|ㄹ/JJ|ㄹ/EE|를/JJ|은/JJ
을러	으르/VB+어/EE
을러져	으르/VB+어/EE+지/VB+어/EE
을러졌	으르/VB+어/EE+지/VB+었/EE
을러진	으르/VB+어/EE+지/VB+ㄴ/EE
을렀	으르/VB+었/EE
음	ㅁ/EE|으/VB+ㅁ/EE|움/NN|은/NN
읍	으/VB+ㅂ/EE|습/EE
읓	이/VB+ㄴ/EE
읖	을/JJ
읜	의/VB+ㄴ/EE|의/NN+이/VB+ㄴ/EE
읠	을/EE
이	일/VB|있/VB|잇/VB
이간	잇가/VB+ㄴ/EE
이갈	잇가/VB+ㄹ/EE
이갔	잇가/VB+았/EE
이놨	잇놓/VB+았/EE
이든	잇들/VB+ㄴ/EE
이볼	잇보/VB+ㄹ/EE
이셨	잇/VB+시/EE+었/EE
이온	잇오/VB+ㄴ/EE
이와	잇오/VB+아/EE
이왔	잇오/VB+았/EE
이은	잇/VB+ㄴ/EE
이을	잇/VB+ㄹ/EE
이음	잇/VB+ㅁ/EE
이인	잇이/VB+ㄴ/EE
이져	잇지/VB+어/EE
이져온	잇지/VB+어/EE+오/VB+ㄴ/EE
이졌	잇지/VB+었/EE
이준	잇주/VB+ㄴ/EE
이줄	잇주/VB+ㄹ/EE
이줬	잇주/VB+었/EE
이진	잇지/VB+ㄴ/EE
이질	잇지/VB+ㄹ/EE
이짐	잇지/VB+ㅁ/EE
인	이/VB+ㄴ/EE
인갈	이/VB+ㄴ/EE+가/EE+ㄹ/JJ
인건	이/VB+ㄴ/EE+것/NN+ㄴ/JJ
인게	이/VB+ㄴ/EE+것/NN+이/JJ
인기	이/VB+ㄴ/EE+지/EE
인달	이/VB+ㄴ/EE+다/EE+ㄹ/EE
인도	이/VB+ㄴ/EE
인런	이/VB+ㄴ/EE+렇/VB+ㄴ/EE
인림	이/VB+ㄴ/EE+리/VB+ㅁ/EE
인봐	이/VB+ㄴ/EE+보/VB+아/EE
인엔	이/VB+ㄴ/EE+에/JJ+ㄴ/JJ
인였	이/VB+ㄴ/EE+이/VB+었/EE
인이	이/VB+ㄴ/EE
인인	이/VB+ㄴ/EE+이/VB+ㄴ/EE
인인와인인	이/VB+ㄴ/EE+이/VB+ㄴ/EE+화/NN+이/VB+ㄴ/EE+이/VB+ㄴ/EE
인인인	이/VB+ㄴ/EE+이/VB+ㄴ/EE+이/VB+ㄴ/EE
인입	이/VB+ㄴ/EE+이/VB+ㅂ/EE
인진	이/NN+이/VB+ㄴ/EE+지/EE+ㄴ/JJ|이/VB+ㄴ/EE+지/VB+ㄴ/EE|이/VB+ㄴ/EE+지/EE+ㄴ/JJ
인한	이/VB+ㄴ/EE+하/XV+ㄴ/EE
일	이/NN+ㄹ/JJ|이/VB+ㄹ/EE|이/VB+ㄹ/JJ
일가	이/VB+ㄹ/EE+까/EE
일거	이/VB+ㄹ/EE+것/NN+이/VB
일꺼	이/VB+ㄹ/EE+거/NN+이/VB
일땐	이/VB+ㄹ/EE+때/NN+ㄴ/JJ
일러	이르/VB+어/EE
일러둘	이르/VB+어/EE+두/VB+ㄹ/EE
일러린	이르/VB+어/EE+리/VB+ㄴ/EE
일러릴	이르/VB+어/EE+리/VB+ㄹ/EE
일러세	이르/VB+어/EE+시/EE+어/EE
일러왔	이르/VB+어/EE+오/VB+았/EE
일러인	이르/VB+어/EE+이/VB+ㄴ/EE
일러준	이르/VB+어/EE+주/VB+ㄴ/EE
일러줄	이르/VB+어/EE+주/VB+ㄹ/EE
일러줌	이르/VB+어/EE+주/VB+ㅁ/EE
일러줘	이르/VB+어/EE+주/VB+어/EE
일러줬	이르/VB+어/EE+주/VB+었/EE
일러진	이르/VB+어/EE+지/VB+ㄴ/EE
일러쳤	이르/VB+어/EE+치/VB+었/EE|이르/VB+치/VB+었/EE
일러친	이르/VB+어/EE+치/VB+ㄴ/EE
일러칠	이르/VB+어/EE+치/VB+ㄹ/EE+이/VB
일렀	이르/VB+었/EE
일렀여	이르/VB+었/EE+어/EE
일봐	이/VB+ㄹ/EE+보/VB+아/EE
일여	이/VB+ㄹ/EE+어/EE
일였	이/VB+ㄹ/EE+이/VB+었/EE
일예	이/VB+ㄹ/EE+이/VB+에/EE
일요	이/VB+ㄹ/EE+이/VB+오/EE
일인	이/VB+ㄹ/EE+이/VB+ㄴ/EE
일입	이/VB+ㄹ/EE+이/VB+ㅂ/EE
일진	이/VB+ㄹ/EE+지/EE+이/VB+ㄴ/EE
일진댄	이/VB+ㄹ/EE+지/EE+이/VB+ㄴ/EE+대/EE+ㄴ/JJ
일치마	잃/VB+지/EE+말/VB
일테	이/VB+ㄹ/EE+터/NN+이/VB|이르/VB+ㄹ/EE+터/NN+이/VB
일텐	이/VB+ㄹ/EE+터/NN+이/VB+ㄴ/EE
일한	이/VB+ㄹ/EE+하/XV+ㄴ/EE|이/VB+ㄹ/EE+하/VB+ㄴ/EE
일했	이/VB+ㄹ/EE+하/XV+았/EE
임	ㅁ/EE|이/NN+이/VB+ㅁ/EE|어/EE+이/VB+ㅁ/EE|ㅁ/EE+이/JJ|이/NN+ㅁ/EE|인/NN|이/VB+ㅁ/EE|이/VB+ㅁ/EE+이/VB
임긴	ㅁ/EE+이/VB+기/EE+ㄴ/JJ
임림	이/VB+ㅁ/EE+리/VB+ㅁ/EE
임엔	이/VB+ㅁ/EE+에/JJ+ㄴ/JJ
임인	이/VB+ㅁ/EE+이/VB+ㄴ/EE
임일	이/VB+ㅁ/EE+이/VB+ㄹ/EE
임입	이/VB+ㅁ/EE+이/VB+ㅂ/EE
임한	이/VB+ㅁ/EE+하/XV+ㄴ/EE
임해	이/VB+ㅁ/EE+하/XV+아/EE
임해온	이/VB+ㅁ/EE+하/XV+아/EE+오/VB+ㄴ/EE
임해왔	이/VB+ㅁ/EE+하/XV+아/EE+오/VB+았/EE
입	이/VB+ㅂ/EE|이/VB+ㅂ/NA|이/VB|이/NN+이/VB+ㅂ/EE|이/VB+ㅂ/EE+"/SY|이/XN+이/VB+ㅂ/EE|이/VB+ㅂ/EE+이/VB|아/EE+이/VB+ㅂ/EE|이/XN+이/VB+ㅂ/EE+이/VB
입만	이/VB+ㅂ/EE+말/VB+ㄴ/EE
입입	이/VB+ㅂ/EE+이/VB+ㅂ/EE
입한	이/VB+ㅂ/EE+하/VB+ㄴ/EE
입했	이/VB+ㅂ/EE+하/VB+았/EE
잇	이/NN|있/VB
있	이/VB+었/EE|었/EE
있났	일나/VB+았/EE
잉	이/VB+ᆼ/NN|이/VB+ᆼ/EE
잎	이/JJ
자	잣/VB|지/VB+아/EE|자/VB+아/EE|좌/NN|잡/VB|지/NN
자기	가지/VB
자나	지/EE+않/VB+아/EE
작인	이/VB+ㄴ/EE
잔	자/EE+ㄴ/EE|자/EE+ㄴ/JJ|자/VB+ㄴ/EE|잘/VB+ㄴ/EE|잖/EE|자/NN+이/VB+ㄴ/EE|자/EE+하/VB+ㄴ/EE|자/NN+ㄴ/JJ
잖	이/VB+지/EE+않/VB|하/VB+지/EE+않/VB|ㄹ/EE+지/EE+않/VB|않/EE|아/EE+지/EE+않/VB|하/XV+지/EE+않/VB|지/EE+않/VB|지/EE+않/VB+았/EE|지/EE+않이/VB|지/EE+않/VB+게/EE
잖애	지/EE+않/VB+아/EE
잖여	지/EE+않/VB+아/EE|이/VB+지/EE+않/VB+아/EE|지/EE+않/VB+어/EE
잖잖	지/EE+않/VB+지/EE+않/VB
잖타	지/EE+않/VB+다/EE
잖해	지/EE+않하/VB+아/EE
잘	자/EE+ㄹ/JJ|자/VB+ㄹ/EE+이/VB|자/EE+하/VB+ㄹ/EE|자/VB+ㄹ/EE|자/NN+이/VB+ㄹ/EE|자/NN+ㄹ/JJ
잘라	자르/VB+아/EE+어/EE|자르/VB+아/EE
잘라낸	자르/VB+아/EE+내/VB+ㄴ/EE
잘라낼	자르/VB+아/EE+내/VB+ㄹ/EE
잘라냄	자르/VB+아/EE+내/VB+ㅁ/EE
잘라냈	자르/VB+아/EE+내/VB+었/EE
잘라둔	자르/VB+아/EE+두/VB+ㄴ/EE
잘라려	자르/VB+아/EE+리/VB+어/EE
잘라렸	자르/VB+아/EE+리/VB+었/EE
잘라린	자르/VB+아/EE+리/VB+ㄴ/EE
잘라릴	자르/VB+아/EE+리/VB+ㄹ/EE
잘라본	자르/VB+아/EE+보/VB+ㄴ/EE
잘라삔	자르/VB+아/EE+삐/VB+ㄴ/EE
잘라세	자르/VB+아/EE+시/EE+어/EE
잘라져	자르/VB+아/EE+지/VB+어/EE
잘라졌	자르/VB+아/EE+지/VB+었/EE
잘라준	자르/VB+아/EE+주/VB+ㄴ/EE
잘라줘	자르/VB+아/EE+주/VB+어/EE
잘라진	자르/VB+아/EE+지/VB+ㄴ/EE
잘라질	자르/VB+아/EE+지/VB+ㄹ/EE
잘라할	자르/VB+아/EE+하/XV+ㄹ/EE
잘라했	자르/VB+아/EE+하/XV+았/EE
잘랐	자르/VB+았/EE
잘러부러	자르/VB+어/EE+불/VB+어/EE
잘려	자르/VB+어/EE
잘봐	자/VB+ㄹ/EE+보/VB+아/EE
잡	집/VB|자/VB+ㅂ/EE|자/NN+이/VB+ㅂ/EE
잤	자/VB+았/EE+이/VB|자/VB+았/EE
잤세	자/VB+았/EE+시/EE+어/EE
재	제/NN|제/MA|째/XN|쟁/XN|의/NN
잰	재/NN+이/VB+ㄴ/EE|재/VB+ㄴ/EE
잴	재/VB+ㄹ/EE
잼	재/VB+ㅁ/EE
잽	재/VB+ㅂ/EE|재/NN+이/VB+ㅂ/EE
쟀	재/VB+었/EE|재/VB+았/EE
쟁	장/XN
쟎	지/EE+않/VB|잖/EE
쟤	저/MM+아이/NN
쟨	저/MM+아이/NN+ㄴ/JJ
저	젓/VB|제/NN|서/JJ|어/VB|절/VB|지/VB+어/EE|제/VB|젓/VB+시/EE|자/NN|젓이/VB|지/VB|주/NN|전/MA
저갈	젓가/VB+ㄹ/EE
저긍	적/XN+으/JJ
저셨	젓/VB+시/EE+었/EE
저슈	젓/VB+시/EE+우/EE
저온	젓오/VB+ㄴ/EE
저인	적/XN+이/VB+ㄴ/EE
저진	젓지/VB+ㄴ/EE
저질	젓/VB+ㄹ/EE+지/EE
적	간/NN
적인	전/NN+이/VB+ㄴ/EE
전	저/NN+ㄴ/JJ|저/NN+이/VB+ㄴ/EE|저/NN+는/JJ|이/VB+저/NN+ㄴ/JJ|절/VB+은/EE|잔/NN|절/VB+ㄴ/EE
전압	저/NN+ㄴ/JJ+알/VB+ㅂ/EE
전요	저/NN+이/VB+ㄴ/EE+이/VB+오/EE
절	저/NN+ㄹ/JJ|저/NN+를/JJ
절러	지르/VB+어/EE
접	저/NN+이/VB+ㅂ/EE|저/NN+ㅂ/EE
정	면/NN|실/NN
정인	종/NN+이/VB+ㄴ/EE
제	적/NN+에/JJ|저/NN+의/JJ|재/NN|저/NN+에/JJ|저/NN+이/VB
제걸	저/NN+의/JJ+것/NN+ㄹ/JJ
제겐	저/NN+에/JJ+게/JJ+ㄴ/JJ
제런	저/NN+의/JJ+렇/VB+ㄴ/EE
제엔	저/NN+의/JJ+에/JJ+ㄴ/JJ
제조인	이/VB+ㄴ/EE
젠	제/XN+이/VB+ㄴ/EE|제/MA+이/VB+ㄴ/EE|제/MA+ㄴ/JJ|제/NN+ㄴ/JJ|적/NN+에/JJ+ㄴ/JJ|제/NN+이/VB+ㄴ/EE
젠인	제/NN+이/VB+ㄴ/EE
젤	제/NN+이/VB+ㄹ/EE|제/NN+ㄹ/JJ
젭	제/MA+이/VB+ㅂ/EE|제/NN+이/VB+ㅂ/EE
져	지/VB+어/EE|지/NN+어/EE|짓/VB+어/EE|어지/VB+어/EE
져간	지/VB+어/EE+가/VB+ㄴ/EE
져갈	지/VB+어/EE+가/VB+ㄹ/EE
져감	지/VB+어/EE+가/VB+ㅁ/EE
져갑	지/VB+어/EE+가/VB+ㅂ/EE
져갔	짓/VB+어/EE+가/VB+았/EE|지/VB+어/EE+가/VB+았/EE
져곤	지/VB+어/EE+고/EE+는/EE
져긴	지/VB+어/EE+기/EE+ㄴ/JJ
져길	지/VB+어/EE+기/EE+ㄹ/JJ
져날	지/VB+어/EE+나/VB+ㄹ/EE
져낸	지/VB+어/EE+내/VB+ㄴ/EE
져낼	지/VB+어/EE+내/VB+ㄹ/EE
져냈	지/VB+어/EE+내/VB+었/EE
져놨	지/VB+어/EE+놓/VB+았/EE
져는	지/VB+어/EE
져댄	지/VB+어/EE+대/VB+ㄴ/EE
져댔	지/VB+어/EE+대/VB+었/EE|지/VB+어/EE+대/VB+았/EE
져둔	지/VB+어/EE+두/VB+ㄴ/EE
져드	지/VB+어/EE+들/VB
져드는	지/VB+어/EE+들/VB+ㄴ/EE
져든	지/VB+어/EE+들/VB+ㄴ/EE
져듭	지/VB+어/EE+들/VB+ㅂ/EE
져려	지/VB+어/EE+리/VB+어/EE
져려갔	지/VB+어/EE+리/VB+어/EE+가/VB+았/EE
져려서	지/VB+어/EE+리/VB
져려진	지/VB+어/EE+리/VB+어/EE+지/VB+ㄴ/EE
져렸	지/VB+어/EE+리/VB+었/EE
져른	지/VB+어/EE+르/VB+ㄴ/EE
져린	지/VB+어/EE+리/VB|지/VB+어/EE+리/VB+ㄴ/EE
져릴	지/VB+어/EE+리/VB+ㄹ/EE
져릴봐	지/VB+어/EE+리/VB+ㄹ/EE+보/VB+아/EE
져릴한	지/VB+어/EE+리/VB+ㄹ/EE+하/XV+ㄴ/EE
져림	지/VB+어/EE+리/VB+ㅁ/EE
져마	지/VB+어/EE+말/VB
져물	지/VB+어/EE+묻/VB
져본	지/VB+어/EE+보/VB+ㄴ/EE
져볼	지/VB+어/EE+보/VB+ㄹ/EE
져봄	지/VB+어/EE+보/VB+ㅁ/EE
져봅	지/VB+어/EE+보/VB+ㅂ/EE
져봐	지/VB+어/EE+보/VB+아/EE+하/VB|지/VB+어/EE+보/VB+아/EE
져봤	지/VB+어/EE+보/VB+았/EE
져봤댔	지/VB+어/EE+보/VB+았/EE+다/EE+하/VB+았/EE
져선	지/VB+어/EE+서/EE+ㄴ/JJ
져설	지/NN+어/EE+서/EE+ㄹ/JJ
져세	지/VB+어/EE+어/EE+시/EE+어/EE|지/VB+어/EE+시/EE+어/EE
져셨	지/VB+어/EE+시/EE+었/EE
져심	지/VB+어/EE+시/EE+ㅁ/EE
져아온	지/VB+어/EE+나오/VB+ㄴ/EE
져여	지/VB+어/EE+이/VB+어/EE
져였	지/VB+어/EE+았/EE|지/VB+어/EE+이/VB+었/EE
져온	지/VB+어/EE+오/VB+ㄴ/EE
져올	지/VB+어/EE+오/VB+ㄹ/EE
져옴	지/VB+어/EE+오/VB+ㅁ/EE
져와	지/VB+어/EE+오/VB|지/VB+어/EE+오/VB+아/EE
져와렸	지/VB+어/EE+오/VB+아/EE+리/VB+었/EE
져왔	지/VB+어/EE+오/VB+았/EE
져인	지/VB+어/EE+이/VB+ㄴ/EE
져자	지/VB+어/EE
져잖	지/VB+어/EE+지/EE+않/VB
져져	지/VB+어/EE+지/VB+어/EE
져져린	지/VB+어/EE+지/VB+어/EE+리/VB+ㄴ/EE
져졌	지/VB+어/EE+지/VB+었/EE
져죠	지/VB+어/EE+지/EE+요/EE
져준	지/VB+어/EE+주/VB+ㄴ/EE|짓/VB+어/EE+주/VB+ㄴ/EE
져줄	지/VB+어/EE+주/VB+ㄹ/EE|주어/VB+지/VB+ㄹ/EE
져줌	지/VB+어/EE+주/VB+ㅁ/EE
져줘	지/VB+어/EE+주/VB+어/EE
져줬	지/VB+어/EE+주/VB+었/EE
져진	지/VB+어/EE+지/VB+ㄴ/EE
져질	어/EE+지/VB+지/EE+ㄹ/JJ|지/VB+어/EE+지/VB+ㄹ/EE
져짐	지/VB+어/EE+지/VB+ㅁ/EE
져집	지/VB+어/EE+지/VB+ㅂ/EE
져파	지/VB+어/EE+프/VB+아/EE
져한	지/VB+어/EE+하/VB+ㄴ/EE|지/VB+어/EE+하/XV+ㄴ/EE
져할	지/VB+어/EE+하/VB+ㄹ/EE
져했	지/VB+어/EE+하/VB+았/EE
졌	지/VB+었/EE
졌간	지/VB+었/EE+가/EE+ㄴ/JJ
졌곤	지/VB+었/EE+고/EE+ㄴ/JJ
졌든	지/VB+었/EE+ㄴ/EE
졌벼	지/VB+었/EE+비/VB+어/EE
졌왔	져오/VB+았/EE
졌잖	지/VB+었/EE+지/EE+않/VB
졌테	지/VB+었/EE+터/NN+이/VB
졌한	지/VB+었/EE+하/VB+ㄴ/EE
조	졸/VB|주/VB+어/EE
조왔	좋/VB+았/EE
족	재/NN|족/NN
존	좋/VB+ㄴ/EE|좋/VB+은/EE|좋/VB+ㄴ/JJ|조/NN+이/VB+ㄴ/EE|졸/VB+ㄴ/EE
졸	좋/VB+을/EE
졸라	조르/VB+아/EE|조르/VB+아/EE+하/VB
졸라댄	조르/VB+아/EE+대/VB+ㄴ/EE
졸라댈	조르/VB+아/EE+대/VB+ㄹ/EE
졸라댑	조르/VB+아/EE+대/VB+ㅂ/EE
졸라댔	조르/VB+아/EE+대/VB+었/EE
졸라릴	조르/VB+아/EE+리/VB+ㄹ/EE
졸라져	조르/VB+아/EE+지/VB+어/EE
졸랐	조르/VB+았/EE
종	속/NN
죈	죄/VB+ㄴ/EE|죄/NN+이/VB+ㄴ/EE
죌	죄/VB+ㄹ/EE
죔	죄/VB+ㅁ/EE
죕	죄/NN+이/VB+ㅂ/EE|죄/NN+이/VB+ㅂ/EE+이/VB
죘	죄/VB+었/EE
주	줍/VB|부/JJ|줄/VB|지/VB+우/EE|지/VB|자/NN|중/NN|줏/VB
주섰주웠	줍/VB+었/EE+줍/VB+었/EE
주였	수/NN+이/VB+었/EE
주우	줍/VB+으/EE|줍/VB
주우셨	줍/VB+으/EE+시/EE+었/EE
주운	줍/VB+은/EE|줍/VB+ㄴ/EE
주울	줍/VB+ㄹ/EE
주워	줏/VB+어/EE|줍/VB+어/EE|줍/VB+어/EE+하/VB|줍/VB+어/EE+으/VB
주워드	줍/VB+어/EE+들/VB
주워든	줍/VB+어/EE+들/VB+ㄴ/EE
주워들	줏/VB+어/EE+듣/VB
주워렸	줍/VB+어/EE+리/VB+었/EE
주워온	줍/VB+어/EE+오/VB+ㄴ/EE
주워와	줍/VB+어/EE+오/VB+아/EE
주워왔	줍/VB+어/EE+오/VB+았/EE
주워은	줍/VB+어/EE+으/VB+ㄴ/EE
주웠	줍/VB+었/EE
주은	줍/VB+ㄴ/EE
죽	중/NN
준	줄/VB+ㄴ/EE|주/VB+ㄴ/EE+이/VB|주/NN+이/VB+ㄴ/EE|아/EE+주/VB+ㄴ/EE|어/EE+주/VB+ㄴ/EE|주/NN+ㄴ/JJ|주/VB+ㄴ/EE|어/EE+어/EE+주/VB+ㄴ/EE|주/VB+ㄴ/EE+아/EE
준거	주/VB+ㄴ/EE+것/NN+이/VB
준단	주/VB+ㄴ/EE+다/JJ+ㄴ/JJ|주/VB+ㄴ/EE+다/EE+ㄴ/JJ
준답	주/VB+ㄴ/EE+다/EE+ㅂ/EE
준댔	주/VB+ㄴ/EE+다/EE+하/VB+았/EE
준봐	주/VB+ㄴ/EE+보/VB+아/EE
준요	주/VB+ㄴ/EE+이/VB+오/EE
준일	주/VB+ㄴ/EE+이/VB+ㄹ/EE
준잖	어/EE+주/VB+ㄴ/EE+지/EE+않/VB
준춰준	어/EE+주/VB+ㄴ/EE+추/VB+어/EE+주/VB+ㄴ/EE
준한	주/VB+ㄴ/EE+하/XV+ㄴ/EE
준해	주/VB+ㄴ/EE+하/VB+아/EE
줄	아/EE+주/VB+ㄹ/EE+이/VB|주/VB+ㄹ/EE+ㄹ/EE|주/VB|주/VB+ㄹ/EE|어/EE+주/VB+ㄹ/EE|주/VB+ㄹ/EE+이/VB|아/EE+주/VB+ㄹ/EE|주/NN+ㄹ/JJ
줄봐	주/VB+ㄹ/EE+보/VB+아/EE
줄예	주/VB+ㄹ/EE+이/VB+에/EE
줄캤	어/EE+주/VB+ㄹ/EE+카/VB+았/EE
줄테	주/VB+ㄹ/EE+터/NN+이/VB|어/EE+주/VB+ㄹ/EE+터/NN+이/VB
줄한	주/VB+ㄹ/EE+하/XV+ㄴ/EE
줄할	주/VB+ㄹ/EE+하/XV+ㄹ/EE
줆	줄/VB+ㅁ/EE
줌	어/EE+주/VB+ㅁ/EE|주/VB+ㅁ/EE|아/EE+주/VB+ㅁ/EE
줍	어/EE+주/VB+ㅂ/EE|으주/VB+ㅂ/EE|주/VB+ㅂ/EE
줏	주/VB|주/NN
중	증/NN
줘	아/EE+주/VB+어/EE|주/VB+어/EE+이/VB|아/EE+주/VB+어/EE+하/VB|어/EE+주/VB+어/EE|주/VB+어/EE+하/VB|주/VB+어/EE
줘나	주/VB+어/EE
줘냈	주/VB+어/EE+내/VB+었/EE
줘돼	주/VB+어/EE+되/VB+어/EE
줘렸	주/VB+어/EE+리/VB+었/EE
줘봐	주/VB+어/EE+보/VB+아/EE
줘선	주/VB+어/EE+서/EE+ㄴ/JJ
줘세	주/VB+어/EE+시/EE+어/EE
줘야	주/VB+어/EE
줘왔	주/VB+어/EE+오/VB+았/EE
줘한	주/VB+어/EE+하/VB+ㄴ/EE
줘할	주/VB+어/EE+하/VB+ㄹ/EE
줘해	주/VB+어/EE+하/XV+아/EE|주/VB+어/EE+하/VB+아/EE
줬	으주/VB+었/EE|아/EE+주/VB+었/EE|어/EE+주/VB+었/EE|주/VB+었/EE
줬단	주/VB+었/EE+다/EE+ㄴ/JJ
줬여	주/VB+었/EE+어/EE
줬잖	주/VB+었/EE+지/EE+않/VB|어/EE+주/VB+었/EE+지/EE+않/VB
쥔	아/EE+쥐/VB+ㄴ/EE|쥐/VB+ㄴ/EE
쥘	아/EE+쥐/VB+ㄹ/EE|쥐/VB+ㄹ/EE|으쥐/VB+ㄹ/EE
쥠	쥐/VB+ㅁ/EE
즘	쯤/XN
즘엔	즈음/NN+에/JJ+ㄴ/JJ
지	짓/VB|질/VB|짓하/VB|직/NN
지갈	짓가/VB+ㄹ/EE
지감	짓가/VB+ㅁ/EE
지갔	짓가/VB+았/EE
지낸	짓내/VB+ㄴ/EE
지놨	짓놓/VB+았/EE
지다	짓달/VB
지둔	짓두/VB+ㄴ/EE
지랄땐	짓/VB+라/EE+ㄹ/EE+때/NN+ㄴ/JJ
지렸	짓리/VB+었/EE
지를	짓/VB+ㄹ/EE
지린	짓리/VB+ㄴ/EE
지립	짓리/VB+ㅂ/EE
지본	짓보/VB+ㄴ/EE
지볼	짓보/VB+ㄹ/EE
지봐	짓보/VB+아/EE
지봤	짓보/VB+았/EE
지선	짓서/VB+ㄴ/EE
지세	짓/VB+시/EE+어/EE
지셔	짓/VB+시/EE+어/EE
지셨	짓/VB+시/EE+었/EE
지신	짓/VB+시/EE+시/EE+ㄴ/EE|짓/VB+시/EE+ㄴ/EE|질/VB+시/EE+ㄴ/EE
지실	짓/VB+시/EE+ㄹ/EE
지십	짓/VB+시/EE+ㅂ/EE|짓/VB+시/EE+시/EE+ㅂ/EE
지였	짓이/VB+었/EE
지온	짓오/VB+ㄴ/EE
지올	짓오/VB+ㄹ/EE
지와	짓오/VB+아/EE
지왔	짓오/VB+았/EE
지울	짓/VB+ㄹ/EE
지움	짓/VB+ㅁ/EE
지워	짓/VB+어/EE
지웠	짓/VB+었/EE
지은	짓/VB+ㄴ/EE
지을	짓/VB+ㄹ/EE
지음	짓/VB+ㅁ/EE+이/VB|짓/VB+ㅁ/EE
지잖	짓/VB+지/EE+않/VB
지준	짓주/VB+ㄴ/EE
지줄	짓주/VB+ㄹ/EE
지줍	짓주/VB+ㅂ/EE
지줘	짓주/VB+어/EE
지줬	짓주/VB+었/EE
직	지/NN+가/JJ|지/NN
진	지/NN+이/VB+ㄴ/EE|지/VB+ㄴ/EE
진거	지/NN+ㄴ/EE+것/NN+이/VB
진건	지/VB+ㄴ/EE+것/NN+ㄴ/JJ
진게	지/VB+ㄴ/EE+것/NN+이/JJ
진러마	지/VB+ㄴ/EE+럽/VB+어/EE+말/VB+아/EE
진얀	지/VB+ㄴ/EE+얗/VB+ㄴ/EE
진인	지/VB+ㄴ/EE+이/VB+ㄴ/EE
진진	지/VB+ㄴ/EE+지/VB+ㄴ/EE
진해	지/VB+ㄴ/EE+하/VB+아/EE
진했	지/EE+ㄴ/JJ+하/VB+았/EE
질	지/NN+이/VB+ㄹ/EE|지/EE+를/JJ|으/VB+지/EE+ㄹ/JJ|지/JJ+ㄹ/EE|지/NN+는/JJ|ㄹ/EE+지/EE|으지/VB+ㄹ/EE|지/NN+ㄹ/JJ|어/EE+지/VB+ㄹ/EE|지르/VB|어/EE+지/EE+ㄹ/JJ|지/EE+ㄹ/JJ|지/VB+ㄹ/EE|ㄴ/EE+지/EE+ㄹ/JJ|지/VB+ㄹ/EE+이/VB|지/EE+?/JJ|지/EE+ㄹ/EE|짓/VB+ㄹ/EE|아/EE+지/VB+ㄹ/EE|아/EE+지/EE+ㄹ/JJ|지/MA
질o	어/EE+지/VB+ㄹ/EE+O/SL
질러	지르/VB+어/EE+아/EE|지르/VB+어/EE+어/EE|지르/VB+어/EE|지르/VB+어/EE+하/VB|지르/VB+어/EE+이/VB
질러간	지르/VB+어/EE+가/VB+ㄴ/EE
질러갈	지르/VB+어/EE+가/VB+ㄹ/EE
질러갔	지르/VB+어/EE+가/VB+았/EE
질러논	지르/VB+어/EE+놓/VB+ㄴ/EE
질러댄	지르/VB+어/EE+대/VB+ㄴ/EE
질러댈	지르/VB+어/EE+대/VB+ㄹ/EE
질러댑	지르/VB+어/EE+대/VB+ㅂ/EE
질러댔	지르/VB+어/EE+대/VB+었/EE
질러렸	지르/VB+어/EE+리/VB+었/EE
질러린	지르/VB+어/EE+리/VB+ㄴ/EE
질러릴	지르/VB+어/EE+리/VB+ㄹ/EE
질러본	지르/VB+어/EE+보/VB+ㄴ/EE
질러봐	지르/VB+어/EE+보/VB+아/EE
질러선	지르/VB+어/EE+서/EE+ㄴ/JJ
질러온	지르/VB+어/EE+오/VB+ㄴ/EE
질러왔	지르/VB+어/EE+오/VB+았/EE
질러져	지르/VB+어/EE+지/VB+어/EE
질러져온	지르/VB+어/EE+지/VB+어/EE+오/VB+ㄴ/EE
질러졌	지르/VB+어/EE+지/VB+었/EE
질러준	지르/VB+어/EE+주/VB+ㄴ/EE
질러진	지르/VB+어/EE+지/VB+ㄴ/EE
질러질	지르/VB+어/EE+지/VB+ㄹ/EE
질렀	지르/VB+었/EE|르/VB+었/EE+지/EE
질렀해	지르/VB+었/EE+하/VB+아/EE
질려	지르/VB+어/EE
질를	지르/VB+ㄹ/EE
질봐	지/VB+ㄹ/EE+보/VB+아/EE
질순	지/VB+ㄹ/EE+수/NN+ㄴ/JJ
질엔	지/VB+ㄹ/EE+에/JJ+ㄴ/JJ
질예	지/VB+ㄹ/EE+이/VB+에/EE
질인	지/VB+ㄹ/EE+이/VB+ㄴ/EE
질진	지지/VB+ㄴ/EE
질테	지/VB+ㄹ/EE+터/NN+이/VB
질텐	지/VB+ㄹ/EE+터/NN+이/VB+ㄴ/EE
질한	지/VB+ㄹ/EE+하/XV+ㄴ/EE|지/VB+ㄹ/EE+하/VB+ㄴ/EE
질할	지/VB+ㄹ/EE+하/XV+ㄹ/EE
짐	어/EE+지/VB+ㅁ/EE|아/EE+지/VB+ㅁ/EE|지/VB+ㅁ/EE
짐.	지/VB+ㅁ/EE
짐일	지/VB+ㅁ/EE+이/VB+ㄹ/EE
짐일진	지/VB+ㅁ/EE+이/VB+ㄹ/EE+지/EE+이/VB+ㄴ/EE
짐한	지/VB+ㅁ/EE+하/VB+ㄴ/EE
집	지/JJ+이/VB+ㅂ/EE|지/NN+ㅂ/EE|어/EE+지/VB+ㅂ/EE|지/VB+ㅂ/EE+이/VB|지/NN+이/VB+ㅂ/EE|어/EE+지/VB+ㅂ/EE+이/VB|아/EE+지/VB+ㅂ/EE|지/VB+ㅂ/EE
짓	지/NN
짖	짓/VB
짜	찌/MA+하/XV
짠	짜/VB+ㄴ/EE|짜/NN+이/VB+ㄴ/EE
짤	짜/NN+이/VB+ㄹ/EE|짜/VB+ㄹ/EE
짤라	짜르/VB+아/EE
짤라려	짜르/VB+아/EE+리/VB+어/EE
짤랐	짜르/VB+았/EE
짬	짜/VB+ㅁ/EE
짭	짜/NN+이/VB+ㅂ/EE
짰	짜/VB+았/EE
째	쩌/VB+어/EE|쩌/VB+아/EE|짜/VB+아/EE|찌/MA+하/XV+아/EE
째볼	쩌/VB+아/EE+보/VB+ㄹ/EE|쩌/VB+어/EE+보/VB+ㄹ/EE
째설	찌/MA+하/XV+아/EE+서/EE+이/VB+ㄹ/EE
째였	찌/MA+하/XV+아/EE+이/VB+었/EE
째인	찌/MA+하/XV+아/EE+이/VB+ㄴ/EE
짼	째/XN+이/VB+ㄴ/EE|째/NN+이/VB+ㄴ/EE|째/XN+ㄴ/EE
짼진	째/XN+이/VB+ㄴ/EE+지/EE+ㄴ/JJ
쨀	째/VB+ㄹ/EE
쨉	째/NN+이/VB+ㅂ/EE
쨌	찌/MA+하/VB+았/EE|쩌/VB+았/EE|찌/MA+하/XV+었/EE|쩌/VB+었/EE|짜/VB+았/EE|찌/VB+었/EE|쩌/VB+ㄹ/EE+았/EE|찌/MA+하/XV+았/EE|짜/VB+었/EE|찌/MA+하/XV+았/EE+이/VB
쩌	찌/MA+하/XV
쩐	쩔/VB+ㄴ/EE|쩌/VB+ㄴ/EE|찌/MA+하/XV+ㄴ/EE
쩔	쩌/VB+ㄹ/EE+이/VB|찌/MA+하/XV+ㄹ/EE|쩌/VB+ㄹ/EE|쩌/VB+ㄹ/EE+ㄹ/EE
쩔테	쩌/VB+ㄹ/EE+터/NN+이/VB
쩜	쩌/VB+ㅁ/EE
쩝	쩌/VB+ㅂ/EE
쪄	쩌/VB+어/EE|찌/VB+어/EE+아/EE|찌/VB+어/EE|찌/VB+아/EE+어/EE
쪄간	찌/VB+어/EE+가/VB+ㄴ/EE
쪄갔	찌/VB+어/EE+가/VB+았/EE
쪄논	찌/VB+어/EE+놓/VB+ㄴ/EE
쪄놔	찌/VB+어/EE+놓/VB+아/EE
쪘	찌/VB+었/EE
쪽	족/MA
쪽여	족/MA+아/EE
쪽한	족/MA+하/XV+ㄴ/EE
쫀	쪼/VB+ㄴ/EE
쫄	쪼/VB+ㄹ/EE
쫌	쪼/VB+ㅁ/EE
쫒	쫓/VB
쫒난	쫓나/VB+ㄴ/EE
쫒냈	쫓내/VB+었/EE
쫬	쪼/VB+았/EE
쬔	쬐/VB+ㄴ/EE
쬘	쬐/VB+ㄹ/EE
쬠	쬐/VB+ㅁ/EE
쭐	쭈/VB+ㄹ/EE
쭙	쭈/VB+ㅂ/EE
쭤	쭈/VB+어/EE
쭤본	쭈/VB+어/EE+보/VB+ㄴ/EE
쭤볼	쭈/VB+어/EE+보/VB+ㄹ/EE
쭤봐	쭈/VB+어/EE+보/VB+아/EE
쭤세	쭈/VB+어/EE+시/EE+어/EE
찌	찡/VB
찌긴	찧기/VB+ㄴ/EE
찌하	쩌/VB+ㄹ/EE
찌해	쩌/VB+ㄹ/EE+아/EE
찍한	직/NN+하/XV+ㄴ/EE
찐	찌/VB+ㄴ/EE|찌/VB+ㄴ/EE+이/VB+라/EE
찔	찌/NA+ㄹ/EE|찧/VB+ㄹ/EE|찌/VB+ㄹ/EE
찔러	찌르/VB+어/EE+아/EE|찌르/VB+어/EE
찔러논	찌르/VB+어/EE+놓/VB+ㄴ/EE
찔러댄	찌르/VB+어/EE+대/VB+ㄴ/EE
찔러댔	찌르/VB+어/EE+대/VB+었/EE
찔러둔	찌르/VB+어/EE+두/VB+ㄴ/EE
찔러린	찌르/VB+어/EE+리/VB+ㄴ/EE
찔러본	찌르/VB+어/EE+보/VB+ㄴ/EE
찔러봤	찌르/VB+어/EE+보/VB+았/EE
찔러와	찌르/VB+어/EE+오/VB+아/EE
찔러왔	찌르/VB+어/EE+오/VB+았/EE
찔러인	찌르/VB+어/EE+이/VB+ㄴ/EE
찔러준	찌르/VB+어/EE+주/VB+ㄴ/EE
찔렀	찌르/VB+었/EE
찔봐	찌/VB+ㄹ/EE+보/VB+아/EE
차와	찹/VB+아/EE
차울	찹/VB+ㄹ/EE
착진	작/NN+지/EE+ㄴ/JJ
찬	차/NN+이/VB+ㄴ/EE|차/NN+ㄴ/EE|차/VB+ㄴ/EE|차/NN+ㄴ/JJ
찬질	차/NN+이/VB+ㄴ/EE+지/EE+ㄹ/JJ
찮	하/XV+지/EE+않/VB|하/VB+지/EE+않/VB|지/EE+않/VB
찰	차/VB+ㄹ/EE|차/NN+ㄹ/JJ|차/VB+ㄹ/JJ
찰봐	차/VB+ㄹ/EE+보/VB+아/EE
참	차/VB+ㅁ/EE|찹/NN
찹	차/VB+ㅂ/EE|차/NN+이/VB+ㅂ/EE|차/NN+이/VB+ㅂ/EE+이/JJ
찹였	차/VB+ㅂ/EE+이/VB+었/EE
찻	차/NN
찼	차/VB+았/EE+이/VB|차/VB+았/EE
창	상/NN+하/XV
찿	찾/VB
책한	택하/VB+ㄴ/EE
챈	채/VB+ㄴ/EE
챌	채/VB+ㄹ/EE
챌봐	채/VB+ㄹ/EE+보/VB+아/EE
챌텐	채/VB+ㄹ/EE+터/NN+이/VB+ㄴ/EE
챔인	채/VB+ㅁ/EE+이/VB+ㄴ/EE
챘	채/VB+었/EE
챘인	채/VB+었/EE+이/VB+ㄴ/EE
챦	하/XV+지/EE+않/VB
처	저/NN|치/VB+어/EE
처였	치/VB+어/EE+이/VB+었/EE
처인	치/VB+어/EE+이/VB+ㄴ/EE
처져	치/VB+어/EE+지/VB+어/EE
천난	청나/VB+ㄴ/EE
철	처/NN
첨	럼/JJ
체	제/NN|쳬/NN
첵	체/NN
첸	체/NN+이/VB+ㄴ/EE
첼	체/NN+ㄹ/JJ
쳅	체/NN+이/VB+ㅂ/EE
쳐	치/VB+어/EE
쳐간	치/VB+어/EE+가/VB+ㄴ/EE
쳐갈	치/VB+어/EE+가/VB+ㄹ/EE
쳐갈봐	치/VB+어/EE+가/VB+ㄹ/EE+보/VB+아/EE
쳐감	치/VB+어/EE+가/VB+ㅁ/EE
쳐갔	치/VB+어/EE+가/VB+았/EE
쳐고	치/VB+어/EE
쳐곤	치/VB+어/EE+고/EE+는/EE
쳐길	치/VB+어/EE+기/EE+ㄹ/JJ
쳐난	치/VB+어/EE+나/VB+ㄴ/EE
쳐날	치/VB+어/EE+나/VB+ㄹ/EE
쳐남	치/VB+어/EE+나/VB+ㅁ/EE
쳐납	치/VB+어/EE+나/VB+ㅂ/EE
쳐났	치/VB+어/EE+나/VB+았/EE
쳐낸	치/VB+어/EE+내/VB+ㄴ/EE
쳐낼	치/VB+어/EE+내/VB+ㄹ/EE
쳐냄	치/VB+어/EE+내/VB+ㅁ/EE
쳐냈	치/VB+어/EE+내/VB+었/EE
쳐녀	치/VB+어/EE+니/VB+어/EE
쳐논	치/VB+어/EE+놓/VB+ㄴ/EE
쳐놔	치/VB+어/EE+놓/VB+아/EE
쳐놨	치/VB+어/EE+놓/VB+았/EE
쳐댄	치/VB+어/EE+대/VB+ㄴ/EE
쳐댈	치/VB+어/EE+대/VB+ㄹ/EE
쳐댔	치/VB+어/EE+대/VB+었/EE
쳐도	치/VB+어/EE+돌/VB
쳐둔	치/VB+어/EE+두/VB+ㄴ/EE
쳐드	치/VB+어/EE+들/VB
쳐든	치/VB+어/EE+들/VB+ㄴ/EE
쳐들	치/VB+어/EE+듣/VB
쳐렀	치/VB+어/EE+리/VB+었/EE
쳐려	치/VB+어/EE+리/VB+어/EE
쳐렸	치/VB+어/EE+리/VB+었/EE
쳐린	치/VB+어/EE+리/VB+ㄴ/EE
쳐릴	치/VB+어/EE+리/VB+ㄹ/EE
쳐림	치/VB+어/EE+리/VB+ㅁ/EE
쳐립	치/VB+어/EE+리/VB+ㅂ/EE
쳐본	치/VB+어/EE+보/VB+ㄴ/EE
쳐볼	치/VB+어/EE+보/VB+ㄹ/EE
쳐봅	치/VB+어/EE+보/VB+ㅂ/EE
쳐봐	치/VB+어/EE+보/VB+아/EE
쳐봤	치/VB+어/EE+보/VB+았/EE
쳐선	치/VB+어/EE+서/EE+ㄴ/JJ
쳐설	치/VB+어/EE+아/EE+서/EE+ㄹ/JJ
쳐세	치/VB+어/EE+시/EE+어/EE
쳐셔	치/VB+어/EE+시/EE+어/EE
쳐셨	치/VB+어/EE+시/EE+었/EE
쳐신	치/VB+어/EE+시/EE+ㄴ/EE
쳐실	치/VB+어/EE+시/EE+ㄹ/EE
쳐십	치/VB+어/EE+시/EE+ㅂ/EE
쳐썼	치/VB+어/EE+쓰/VB+었/EE
쳐얄	치/VB+어/EE+야/EE+하/VB+ㄹ/EE
쳐엔	치/VB+어/EE+에/JJ+ㄴ/JJ
쳐여	치/VB+어/EE+이/VB+어/EE
쳐였	치/VB+어/EE+이/VB+었/EE
쳐온	치/VB+어/EE+오/VB+ㄴ/EE
쳐올	치/VB+어/EE+오/VB+ㄹ/EE
쳐올라	치/VB+어/EE+오르/VB+아/EE
쳐올랐	치/VB+어/EE+오르/VB+았/EE
쳐옴	치/VB+어/EE+오/VB+ㅁ/EE
쳐와	치/VB+어/EE+오/VB+아/EE
쳐왔	치/VB+어/EE+오/VB+았/EE
쳐운	치/VB+어/EE+우/VB+ㄴ/EE
쳐인	치/VB+어/EE+이/VB+ㄴ/EE
쳐일	치/VB+어/EE+이/VB+ㄹ/EE
쳐저	치/VB+어/EE+지/VB+어/EE
쳐져	치/VB+어/EE+지/VB+어/EE|처지/VB+어/EE
쳐져간	치/VB+어/EE+지/VB+어/EE+가/VB+ㄴ/EE
쳐져인	치/VB+어/EE+지/VB+어/EE+이/VB+ㄴ/EE
쳐져할	치/VB+어/EE+지/VB+어/EE+하/VB+ㄹ/EE
쳐졌	치/VB+어/EE+지/VB+었/EE
쳐준	치/VB+어/EE+주/VB+ㄴ/EE
쳐줄	치/VB+어/EE+주/VB+ㄹ/EE
쳐줍	치/VB+어/EE+주/VB+ㅂ/EE
쳐줘	치/VB+어/EE+주/VB+어/EE+하/VB|치/VB+어/EE+주/VB+어/EE
쳐줘해	치/VB+어/EE+주/VB+어/EE+하/VB+아/EE
쳐줬	치/VB+어/EE+주/VB+었/EE
쳐진	치/VB+어/EE+지/EE+ㄴ/JJ|치/VB+어/EE+지/VB+ㄴ/EE
쳐질	치/VB+어/EE+지/VB+ㄹ/EE
쳐짐	치/VB+어/EE+지/VB+ㅁ/EE
쳐집	치/VB+어/EE+지/VB+ㅂ/EE
쳐한	치/VB+어/EE+하/VB+ㄴ/EE
쳐할	치/VB+어/EE+하/VB+ㄹ/EE
쳐해	치/VB+어/EE+하/VB+아/EE
쳐했	치/VB+어/EE+하/VB+았/EE
쳤	치/NN+었/EE|치/VB+었/EE+이/VB|치/VB+었/EE
쳤”	치/VB+었/EE+"/SY
쳤간	치/VB+었/EE+가/EE+ㄴ/JJ
쳤겁	치/VB+었/EE+것/NN+이/VB+ㅂ/EE
쳤댔	치/VB+었/EE+다/EE+하/VB+았/EE
쳤봐	치/VB+었/EE+보/VB+아/EE
쳤여	치/VB+었/EE+어/EE
쳤잖	치/VB+었/EE+지/EE+않/VB
쳤진	치/VB+었/EE+지/EE+ㄴ/JJ
촐	초/NN+이/VB+ㄹ/EE
촐했	출/NN+하/XV+았/EE
쵸	치/VB+요/EE
추	춥/VB
추려든	츠리/VB+어/EE+들/VB+ㄴ/EE
추우	춥/VB+으/EE|춥/VB
추우세	춥/VB+시/EE+어/EE
추운	춥/VB+은/EE|춥/VB+ㄴ/EE
추운거	춥/VB+ㄴ/EE+것/NN
추울	춥/VB+ㄹ/EE|춥/VB+을/EE
추울봐	춥/VB+ㄹ/EE+보/VB+아/EE
추울텐	춥/VB+을/EE+터/NN+이/VB+ㄴ/EE
추움더움	춥/VB+ㅁ/EE+덥/VB+ㅁ/EE
추워	춥/VB+어/EE
추워였	춥/VB+어/EE+이/VB+었/EE
추워왔	춥/VB+어/EE+오/VB+았/EE
추워인	춥/VB+어/EE+이/VB+ㄴ/EE
추워잖	춥/VB+어/EE+지/EE+않/VB
추워져	춥/VB+어/EE+지/VB+어/EE
추워졌	춥/VB+어/EE+지/VB+었/EE
추워진	춥/VB+어/EE+지/VB+ㄴ/EE
추워질	춥/VB+어/EE+지/VB+ㄹ/EE
추워집	춥/VB+어/EE+지/VB+ㅂ/EE
추웠	춥/VB+었/EE
축	추/NN
춘	춥/VB+ㄴ/EE|추/VB+ㄴ/EE
춘여	추/VB+ㄴ/EE+아/EE
출	추/VB+ㄹ/EE|추/VB+ㄹ/EE+이/VB|춥/VB+ㄹ/EE
출봐	추/VB+ㄹ/EE+보/VB+아/EE
춤	추/VB+ㅁ/EE
춥	추/VB+ㅂ/EE|아/EE+추/VB+ㅂ/EE
춧	추/NN
춰	추/VB+어/EE
춰간	추/VB+어/EE+가/VB+ㄴ/EE
춰날	추/VB+어/EE+나/VB+ㄹ/EE
춰낸	추어/VB+내/VB+ㄴ/EE
춰낼	추어/VB+내/VB+ㄹ/EE
춰냄	추어/VB+내/VB+ㅁ/EE
춰냈	추/VB+어/EE+내/VB+었/EE|추어/VB+내/VB+었/EE
춰놔	추/VB+어/EE+놓/VB+아/EE
춰놨	추/VB+어/EE+놓/VB+았/EE
춰댈	추/VB+어/EE+대/VB+ㄹ/EE
춰둔	추/VB+어/EE+두/VB+ㄴ/EE
춰둘	추/VB+어/EE+두/VB+ㄹ/EE
춰둬	추/VB+어/EE+두/VB+어/EE
춰든	추/VB+어/EE+들/VB+ㄴ/EE
춰렸	추/VB+어/EE+리/VB+었/EE
춰린	추/VB+어/EE+리/VB+ㄴ/EE
춰릴	추/VB+어/EE+리/VB+ㄹ/EE
춰본	추/VB+어/EE+보/VB+ㄴ/EE
춰볼	추/VB+어/EE+보/VB+ㄹ/EE
춰봄	추/VB+어/EE+보/VB+ㅁ/EE
춰봐	추/VB+어/EE+보/VB+아/EE
춰봤	추/VB+어/EE+보/VB+았/EE
춰선	추/VB+어/EE+서/VB+ㄴ/EE|추/VB+어/EE+서/EE+ㄴ/JJ
춰설	추/VB+어/EE+서/EE+ㄹ/JJ
춰섰	추/VB+어/EE+서/VB+었/EE
춰셔	추/VB+어/EE+시/EE+어/EE
춰였	추/VB+어/EE+이/VB+었/EE
춰온	추/VB+어/EE+오/VB+ㄴ/EE
춰와	추/VB+어/EE+오/VB+아/EE
춰왔	추/VB+어/EE+오/VB+았/EE
춰울	추/VB+어/EE+우/VB+ㄹ/EE
춰으며	추/VB+어/EE+어/EE
춰져	추/VB+어/EE+지/VB+어/EE
춰져왔	추/VB+어/EE+지/VB+어/EE+오/VB+았/EE
춰졌	추/VB+어/EE+지/VB+었/EE
춰준	추/VB+어/EE+주/VB+ㄴ/EE
춰줄	추/VB+어/EE+주/VB+ㄹ/EE
춰줘	추/VB+어/EE+주/VB+어/EE
춰진	추/VB+어/EE+지/VB+ㄴ/EE
춰질	추/VB+어/EE+지/VB+ㄹ/EE
춰칠	추/VB+어/EE+지/VB+어/EE+ㄹ/EE
췄	어/EE+추/VB+었/EE|추/VB+었/EE
췄간	추/VB+었/EE+가/EE+ㄴ/JJ
츤	촌/NN
치	하/XV+지/EE
치는	하/XV+지/EE+ㄴ/JJ
치른	칠/VB+은/EE
치운	칩/VB+ㄴ/EE
치할	하/VB+지/EE+하/VB+ㄹ/EE
친	칠/VB+ㄴ/EE|하/XV+지/EE+ㄴ/JJ|치/NN+ㄴ/JJ|치/NN+이/VB+ㄴ/EE|치/VB+ㄴ/EE
친린	치/VB+ㄴ/EE+리/VB+ㄴ/EE
친인	치/VB+ㄴ/EE+이/VB+ㄴ/EE
친한	치/VB+ㄴ/EE+하/XV+ㄴ/EE
칠	치/NN+이/VB+ㄹ/EE|하/VB+지/EE+ㄹ/JJ|치/VB+ㄹ/EE|하/XV+지/EE+ㄹ/JJ|치/NN+ㄹ/JJ
칠봐	치/VB+ㄹ/EE+보/VB+아/EE
칠테	치/VB+ㄹ/EE+터/NN+이/VB
칠한	치/VB+ㄹ/EE+하/XV+ㄴ/EE
침	칠/VB+ㅁ/EE|치/VB+ㅁ/EE
침셨	치/VB+ㅁ/EE+시/EE+었/EE
침일	치/VB+ㅁ/EE+이/VB+ㄹ/EE
침입	치/VB+ㅁ/EE+이/VB+ㅂ/EE
침침	치/VB+ㅁ/EE+치/MA+ㅁ/EE
침해	치/VB+ㅁ/EE+하/XV+아/EE
칩	치/VB+ㅂ/EE|치/NN+이/VB+ㅂ/EE
카	하/VB|칼/NN|렇/VB+게/EE+하/VB|이하/VB
칸	카/VB+ㄴ/EE|카/NN+이/VB+ㄴ/EE
캅	카/VB+ㅂ/EE
캐	카/VB+아/EE|렇/VB+게/EE+하/VB+아/EE|카/VB
캔	캐/VB+ㄴ/EE|갠/NN
캘	캐/VB+ㄹ/EE
캤	캐/VB+었/EE|카/VB+았/EE
커	하/VB+거/EE|하/XV+거/EE|크/VB+어/EE
커간	크/VB+어/EE+가/VB+ㄴ/EE
커갈	크/VB+어/EE+가/VB+ㄹ/EE
커감	크/VB+어/EE+가/VB+ㅁ/EE
커갔	크/VB+어/EE+가/VB+았/EE
커렸	크/VB+어/EE+리/VB+었/EE
커렸잖	크/VB+어/EE+리/VB+었/EE+지/EE+않/VB
커린	크/VB+어/EE+리/VB+ㄴ/EE
커였	크/VB+어/EE+이/VB+었/EE
커온	크/VB+어/EE+오/VB+ㄴ/EE
커왔	크/VB+어/EE+오/VB+았/EE
커왔잖	크/VB+어/EE+오/VB+았/EE+지/EE+않/VB
커인	크/VB+어/EE+이/VB+ㄴ/EE
커일	크/VB+어/EE+이/VB+ㄹ/EE
커준	크/VB+어/EE+주/VB+ㄴ/EE
커한	크/VB+어/EE+하/VB+ㄴ/EE
커했	크/VB+어/EE+하/VB+았/EE
컨	하/VB+건/EE|하/XV+건/EE
컬	컫/VB|커/VB+ㄹ/EE
컬왔	컫오/VB+았/EE
컬인	컫이/VB+ㄴ/EE
컬져	컫지/VB+어/EE
컬져왔	컫지/VB+어/EE+오/VB+았/EE
컬졌	컫지/VB+었/EE
컬진	컫지/VB+ㄴ/EE
컬질	컫지/VB+ㄹ/EE
컸	하/XV+겄/EE|크/VB+었/EE
컸봐	크/VB+었/EE+보/VB+아/EE
컸였	크/VB+었/EE+이/VB+었/EE
컸일	크/VB+었/EE+이/VB+ㄹ/EE
컸텐	크/VB+었/EE+터/NN+이/VB+ㄴ/EE
케	하/XV+게/EE|하/VB+게/EE
케된	하/XV+게/EE+되/XV+ㄴ/EE
케여	게/EE+하/VB+아/EE
케한	하/XV+게/EE+하/VB+ㄴ/EE
케할	하/XV+게/EE+하/VB+ㄹ/EE
케했	하/XV+게/EE+하/VB+았/EE
켔	하/VB+겠/EE
켜	키/VB+어/EE|키/XV+어/EE
켜가	키/XV+어/EE+가/VB
켜간	키/XV+어/EE+가/VB+ㄴ/EE|키/VB+어/EE+가/VB+ㄴ/EE
켜갈	키/VB+어/EE+가/VB+ㄹ/EE|키/XV+어/EE+가/VB+ㄹ/EE
켜감	키/VB+어/EE+가/VB+ㅁ/EE|키/XV+어/EE+가/VB+ㅁ/EE
켜갔	키/VB+어/EE+가/VB+았/EE|키/XV+어/EE+가/VB+았/EE
켜길	키/VB+어/EE+기/EE+를/JJ
켜낸	키/VB+어/EE+내/VB+ㄴ/EE
켜낼	키/VB+어/EE+내/VB+ㄹ/EE
켜냈	키/VB+어/EE+내/VB+었/EE
켜논	키/VB+어/EE+놓/VB+ㄴ/EE
켜놔	키/VB+어/EE+놓/VB+아/EE
켜돼	키/VB+어/EE+되/VB+어/EE
켜둔	키/XV+어/EE+두/VB+ㄴ/EE
켜둘	키/XV+어/EE+두/VB+ㄹ/EE
켜랬	키/VB+어/EE+라/EE+하/VB+았/EE
켜려	키/VB+어/EE+리/VB+어/EE
켜렸	키/VB+어/EE+리/VB+었/EE|키/XV+어/EE+리/VB+었/EE|키/VB+아/EE+리/VB+었/EE
켜린	키/VB+어/EE+리/VB+ㄴ/EE|키/XV+어/EE+리/VB+ㄴ/EE
켜릴	키/XV+어/EE+리/VB+ㄹ/EE|키/VB+어/EE+리/VB+ㄹ/EE
켜본	키/XV+어/EE+보/VB+ㄴ/EE|키/VB+어/EE+보/VB+ㄴ/EE
켜볼	키/VB+어/EE+보/VB+ㄹ/EE|키/XV+어/EE+보/VB+ㄹ/EE
켜봄	키/VB+어/EE+보/VB+ㅁ/EE
켜봐	키/VB+어/EE+보/VB+아/EE
켜봤	키/VB+어/EE+보/VB+았/EE
켜선	키/XV+어/EE+서/EE+ㄴ/JJ|키/VB+어/EE+서/EE+ㄴ/JJ
켜섰	키/VB+어/EE+서/VB+었/EE+이/VB
켜세	키/VB+어/EE+시/EE+어/EE|키/XV+어/EE+시/EE+어/EE
켜셔	키/VB+어/EE+시/EE+어/EE|키/VB+어/EE+시/EE+어/EE+하/VB
켜셨	키/VB+어/EE+시/EE+었/EE
켜신	키/VB+어/EE+시/EE+ㄴ/EE
켜온	키/VB+어/EE+오/VB+ㄴ/EE|키/XV+어/EE+오/VB+ㄴ/EE
켜올	키/VB+어/EE+오/VB+ㄹ/EE
켜올라	키/VB+어/EE+오르/VB+아/EE
켜올랐	키/VB+어/EE+오르/VB+았/EE
켜왔	키/XV+어/EE+오/VB+았/EE|키/VB+어/EE+오/VB+았/EE
켜운	키/VB+어/EE+우/VB+ㄴ/EE
켜울	키/VB+어/EE+우/VB+ㄹ/EE
켜워	키/VB+어/EE+우/VB+어/EE
켜웠	키/VB+어/EE+우/VB+었/EE
켜인	키/VB+어/EE+이/VB+ㄴ/EE
켜일	키/XV+어/EE+이/VB+ㄹ/EE
켜져	키/VB+어/EE+지/VB+어/EE
켜져온	키/VB+어/EE+지/VB+어/EE+오/VB+ㄴ/EE
켜졌	키/VB+어/EE+지/VB+었/EE
켜준	키/VB+어/EE+주/VB+ㄴ/EE|키/XV+어/EE+주/VB+ㄴ/EE
켜줄	키/VB+어/EE+주/VB+ㄹ/EE|키/XV+어/EE+주/VB+ㄹ/EE
켜줄게	키/VB+어/EE+주/VB+ㄹ/EE+거/NN+이/JJ
켜줌	키/VB+어/EE+주/VB+ㅁ/EE|키/XV+어/EE+주/VB+ㅁ/EE
켜줘	키/XV+어/EE+주/VB+어/EE|키/VB+어/EE+주/VB+어/EE+하/VB|키/VB+어/EE+주/VB+어/EE
켜줬	키/VB+어/EE+주/VB+었/EE|키/XV+어/EE+주/VB+었/EE
켜진	키/VB+어/EE+지/VB+ㄴ/EE|키/XV+어/EE+지/VB+ㄴ/EE|키/VB+어/EE+지/EE+ㄴ/JJ
켜질	키/VB+어/EE+지/VB+ㄹ/EE|키/VB+어/EE+지/EE+ㄹ/JJ
켜한	키/VB+어/EE+하/VB+ㄴ/EE
켠	키/VB+ㄴ/EE|켜/VB+ㄴ/EE
켤	켜/VB+ㄹ/EE
켭	켜/VB+ㅂ/EE
켰	켜/VB+었/EE|키/VB+었/EE|키/XV+었/EE
켰간	키/VB+었/EE+가/EE+ㄴ/JJ
켰껐	켜/VB+었/EE+끄/VB+었/EE
켰였	키/XV+었/EE+이/VB+었/EE
켰잖	키/XV+었/EE+지/EE+않/VB|키/VB+었/EE+지/EE+않/VB
코	하/XV+고/EE|하/VB+고/EE
콘	코/MA+ㄴ/JJ|콜/NN
쿠	하/XV+구/EE
쿨	쿠/VB+ㄹ/EE
퀸	퀴/NN+이/VB+ㄴ/EE|퀴/VB+ㄴ/EE
퀼	퀴/VB+ㄹ/EE
크러	클/VB+어/EE
크러져	클어/VB+지/VB+어/EE
크러진	클어/VB+지/VB+ㄴ/EE
큰	크/VB+ㄴ/EE|크/NN+이/VB+ㄴ/EE
큰게	크/VB+ㄴ/EE+것/NN+이/JJ
큰났	크/VB+ㄴ/EE+나/VB+았/EE
큰엔	크/VB+ㄴ/EE+에/JJ+ㄴ/JJ
큰인	크/VB+ㄴ/EE+이/VB+ㄴ/EE
큰친	크/VB+ㄴ/EE+치/VB+ㄴ/EE
큰칠	크/VB+ㄴ/EE+치/VB+ㄹ/EE
큰한	크/VB+ㄴ/EE+하/XV+ㄴ/EE
클	크/VB+ㄹ/EE+ㄹ/EE|크/NN+ㄹ/JJ|크/VB+ㄹ/EE
클한	크/VB+ㄹ/EE+ㄹ/EE+하/VB+ㄴ/EE
큼	크/VB+ㅁ/EE
큽	크/VB+ㅂ/EE
키	기/NN|하/VB+기/EE|켜/VB|하/XV+기/EE|어/EE+하/VB+기/EE+이/VB
키한	하/XV+기/EE+하/VB+ㄴ/EE
킨	키/VB+ㄴ/EE+이/VB|키/XV|키/XV+ㄴ/EE|키/NA+ㄴ/EE|키/NN+ㄴ/JJ|하/XV+기/EE+ㄴ/JJ|키/VB+ㄴ/EE
킨’여	키/VB+ㄴ/EE+'/SY+아/EE
킨여진	키/XV+ㄴ/EE+이/VB+어/EE+지/VB+ㄴ/EE
킨튼	키/VB+ㄴ/EE+트/VB+ㄴ/EE
킬	키/VB+ㄹ/EE|하/XV+기/EE+ㄹ/JJ|키/XV+ㄹ/EE+이/VB|어/EE+하/VB+기/EE+ㄹ/JJ|키/XV+ㄹ/EE
킬봐	키/VB+ㄹ/EE+보/VB+아/EE|키/XV+ㄹ/EE+보/VB+아/EE
킬한	키/XV+ㄹ/EE+하/XV+ㄴ/EE|키/VB+ㄹ/EE+하/XV+ㄴ/EE
킴	키/VB+ㅁ/EE|키/XV+ㅁ/EE
킴과	키/XV+고/EE
킴인	키/VB+ㅁ/EE+이/VB+ㄴ/EE
킴일	키/VB+ㅁ/EE+이/VB+ㄹ/EE
킵	키/XV+ㅂ/EE|키/VB+ㅂ/EE
타	하/VB+다/EE|하/XV+다/EE|다/EE
타와	탑/VB+아/EE
타와졌	탑/VB+아/EE+지/VB+었/EE
탁	탄/NN
탄	타/VB+ㄴ/EE+이/VB|타/VB+ㄴ/EE|타/NN+이/VB+ㄴ/EE
탈	타/NN+ㄹ/JJ|타/VB+ㄹ/EE
탈봐	타보/VB+아/EE|타/VB+ㄹ/EE+보/VB+아/EE
탑	타/VB+ㅂ/EE|타/NA+ㅂ/EE
탓	타/VB+았/EE
탔	타/VB+았/EE
탔봐	타/VB+았/EE+보/VB+아/EE
탕	하/VB+당/EE
탠	태/VB+ㄴ/EE|태/NN+이/VB+ㄴ/EE
탤	태/VB+ㄹ/EE
탬	태/VB+ㅁ/EE
탰	태/VB+었/EE
터	트/VB+어/EE|하/XV+더/EE|털/VB
터른	트/VB+어/EE+르/VB+ㄴ/EE
터를	트/VB+어/EE+르/VB+ㄹ/EE
터본	트/VB+어/EE+보/VB+ㄴ/EE
터볼	트/VB+어/EE+보/VB+ㄹ/EE
터십	트/VB+어/EE+시/EE+ㅂ/EE
터온	트/VB+어/EE+오/VB+ㄴ/EE
터올	트/VB+아/EE+오/VB+ㄹ/EE|트/VB+어/EE+오/VB+ㄹ/EE
터올랐	트/VB+어/EE+오르/VB+았/EE
터우	텁/VB
터운	텁/VB+ㄴ/EE|텁/VB+은/EE
터울	텁/VB+ㄹ/EE
터움	텁/VB+ㅁ/EE
터워	텁/VB+어/EE
터워졌	텁/VB+어/EE+지/VB+었/EE
터워진	텁/VB+어/EE+지/VB+ㄴ/EE
터워질	텁/VB+어/EE+지/VB+ㄹ/EE
터워짐	텁/VB+어/EE+지/VB+ㅁ/EE
터웠	텁/VB+었/EE
터준	트/VB+어/EE+주/VB+ㄴ/EE
터줘	트/VB+어/EE+주/VB+어/EE
터줬	트/VB+어/EE+주/VB+었/EE
턴	터/NN+ㄴ/JJ|하/XV+던/EE|터/JJ+ㄴ/JJ|터/NN+이/VB+ㄴ/EE|터/JJ+이/VB+ㄴ/EE|털/VB+ㄴ/EE
텁	터/JJ+이/VB+ㅂ/EE
텄	트/VB+었/EE
테	터/NN+이/VB|터/NN|ㄹ/EE+터/NN+이/VB|터/NN+이/VB+라/EE
테가	터/NN+이/VB+까/EE
테깐	터/NN+이/VB+까/EE+ㄴ/JJ
테니	라오/VB+았/EE
테여	터/NN+이/VB+어/EE
테요	터/NN+이/VB+오/EE
테한	터/NN+이/VB+하/XV+ㄴ/EE
텐	터/NN+이/VB+ㄴ/EE
텡	터/NN+이/VB+ㅇ/EE
텨	티/VB+어/EE|티/NN+이/VB
텨간	티/VB+어/EE+가/VB+ㄴ/EE
텨갈	티/VB+어/EE+가/VB+ㄹ/EE
텨낸	티/VB+어/EE+내/VB+ㄴ/EE
텨낼	티/VB+어/EE+내/VB+ㄹ/EE
텨냈	티/VB+어/EE+내/VB+었/EE
텨본	티/VB+어/EE+보/VB+ㄴ/EE
텨봐	티/VB+어/EE+보/VB+아/EE
텨섰	티/VB+어/EE+서/VB+었/EE
텨온	티/VB+어/EE+오/VB+ㄴ/EE
텨왔	티/VB+어/EE+오/VB+았/EE
텨준	티/VB+어/EE+주/VB+ㄴ/EE
텨줬	티/VB+어/EE+주/VB+었/EE
텼	티/VB+었/EE
토	도/EE|하/XV+도/EE|하/VB+도/EE
토한	하/XV+도/EE+하/VB+ㄴ/EE
토함	하/XV+도/EE+하/VB+ㅁ/EE
토해	하/XV+도/EE+하/VB+아/EE
톨	토/NN+ㄹ/JJ
톱	톰/NN
통	동/NN
톺온	돌오/VB+ㄴ/EE
퇭	됑/NN
투	툴/VB
투깐	툴/VB+까/EE+ㄴ/JJ
툰	투/VB+ㄴ/EE|툴/VB+ㄴ/EE|툴/VB+ㄹ/EE
툴	투/VB+ㄹ/EE
툴러	투르/VB+어/EE
툴렀	투르/VB+었/EE
툼	투/VB+ㅁ/EE
퉈	투/VB+어/EE
퉈린	투/VB+어/EE+리/VB+ㄴ/EE
퉈본	투/VB+어/EE+보/VB+ㄴ/EE
퉜	투/VB+었/EE
튄	튀/VB+ㄴ/EE
튈	튀/VB+ㄹ/EE
튈봐	튀/VB+ㄹ/EE+보/VB+아/EE
트	틀/VB
튼	틀/VB+ㄴ/EE|트/NN+ㄴ/JJ|하/VB+든/EE|트/NN+이/VB+ㄴ/EE|트/VB+ㄴ/EE
튼느	트/VB+ㄴ/EE+늘/VB
틀	트/VB+ㄹ/EE
틈	트/VB+ㅁ/EE
틉	트/VB+ㅂ/EE
티마	하/XV+디/EE+말/VB
틴	티/VB+ㄴ/EE|티/NN+이/VB+ㄴ/EE
틸	티/VB+ㄹ/EE
팀	티/VB+ㅁ/EE
팅	티/NN+이/VB+ᆼ/EE
파	팡/NN|프/VB+아/EE|프/VB+아/EE+이/VB|팔/VB|팎/NN|어/EE+팔/VB
파게	팔/VB+것/NN+이/JJ
파본	프/VB+아/EE+보/VB+ㄴ/EE
파세	팔/VB+시/EE+어/EE
파셧	프/VB+아/EE+시/EE+었/EE
파셨	팔/VB+시/EE+었/EE
파신	팔/VB+시/EE+ㄴ/EE
파실	프/VB+아/EE+시/EE+ㄹ/EE|팔/VB+시/EE+ㄹ/EE
파십	팔/VB+시/EE+ㅂ/EE
파였	프/VB+아/EE+았/EE|프/VB+아/EE+이/VB+었/EE
파온	프/VB+아/EE+오/VB+ㄴ/EE
파올	프/VB+아/EE+오/VB+ㄹ/EE
파와	프/VB+아/EE+오/VB+아/EE
파왔	프/VB+아/EE+오/VB+았/EE
파인	프/VB+아/EE+이/VB+ㄴ/EE
파져	프/VB+아/EE+지/VB+어/EE
파져왔	프/VB+아/EE+지/VB+어/EE+오/VB+았/EE
파졌	프/VB+아/EE+지/VB+었/EE
파진	프/VB+아/EE+지/VB+ㄴ/EE
파질	프/VB+아/EE+지/VB+ㄹ/EE
파한	프/VB+아/EE+하/VB+ㄴ/EE
파할	프/VB+아/EE+하/VB+ㄹ/EE
파했	프/VB+아/EE+하/VB+았/EE
팍	팎/NN
판	어/EE+팔/VB+ㄴ/EE|팔/VB+ㄴ/EE|파/VB+ㄴ/EE|파/NN+이/VB+ㄴ/EE|팔/VB+ㄴ/EE+이/VB
팔	파/VB+ㄹ/EE
팔라	파르/VB+아/EE
팔라졌	파르/VB+아/EE+지/VB+었/EE
팔라진	파르/VB+아/EE+지/VB+ㄴ/EE
팔랐	파르/VB+았/EE
팔진	파르/VB+아/EE+지/VB+ㄴ/EE
팝	파/VB+ㅂ/EE|팔/VB+ㅂ/EE
팠	파/VB+았/EE|프/VB+았/EE|프/VB+었/EE
팠잖	프/VB+았/EE+지/EE+않/VB
팬	패/NN+이/VB+ㄴ/EE|패/NN+ㄴ/JJ|패이/VB+ㄴ/EE|패/VB+ㄴ/EE
팰	패/VB+ㄹ/EE
팰러	패/VB+ㄹ/EE+렇/VB
팹	패/NN+이/VB+ㅂ/EE
팼	패/VB+었/EE
퍼	프/VB+었/EE|푸/VB+어/EE+아/EE|프/VB|프/VB+어/EE|푸/VB+어/EE
퍼려	푸/VB+어/EE+리/VB+어/EE
퍼렸	푸/VB+어/EE+리/VB+었/EE
퍼린	푸/VB+어/EE+리/VB+ㄴ/EE
퍼릴	푸/VB+어/EE+리/VB+ㄹ/EE
퍼마	프/VB+어/EE+말/VB+아/EE
퍼여	푸/VB+어/EE+이/VB+어/EE|프/VB+어/EE+아/EE
퍼온	푸/VB+어/EE+오/VB+ㄴ/EE
퍼와	푸/VB+어/EE+오/VB+아/EE
퍼일	푸/VB+어/EE+이/VB+ㄹ/EE
퍼져	프/VB+어/EE+지/VB+어/EE
퍼졌	프/VB+어/EE+지/VB+었/EE
퍼준	푸/VB+어/EE+주/VB+ㄴ/EE
퍼줄	푸/VB+어/EE+주/VB+ㄹ/EE
퍼줘	푸/VB+어/EE+주/VB+어/EE
퍼진	프/VB+어/EE+지/VB+ㄴ/EE
퍼질	프/VB+어/EE+지/VB+ㄹ/EE
퍼집	프/VB+어/EE+지/VB+ㅂ/EE
퍼한	프/VB+어/EE+하/VB+ㄴ/EE
퍼할	프/VB+어/EE+하/VB+ㄹ/EE
펐	프/VB+었/EE|푸/VB+었/EE
페	테/NN
펴	피/VB+어/EE|어/EE+피/VB+어/EE|피/VB+어/EE+하/VB
펴갔	피/VB+어/EE+가/VB+았/EE
펴긴	피/VB+어/EE+기/EE+ㄴ/JJ
펴낸	피/VB+어/EE+내/VB+ㄴ/EE
펴놔	피/VB+어/EE+놓/VB+아/EE
펴른	피어/VB+르/VB+ㄴ/EE
펴본	피/VB+어/EE+보/VB+ㄴ/EE
펴볼	피/VB+어/EE+보/VB+ㄹ/EE
펴십	피/VB+어/EE+시/EE+ㅂ/EE
펴온	피/VB+어/EE+오/VB+ㄴ/EE
펴져	피/VB+어/EE+지/VB+어/EE
펴졌	피/VB+어/EE+지/VB+었/EE
펴준	피/VB+어/EE+주/VB+ㄴ/EE
펴줄	피/VB+어/EE+주/VB+ㄹ/EE
펴줘	피/VB+어/EE+주/VB+어/EE
펴줬	피/VB+어/EE+주/VB+었/EE
펴진	피/VB+어/EE+지/VB+ㄴ/EE
펴질	피/VB+어/EE+지/VB+ㄹ/EE
펴한	피/VB+어/EE+하/VB+ㄴ/EE
편	펴/VB+ㄴ/EE
펼	펴/VB+ㄹ/EE
펼게	펴/VB+ㄹ/EE+것/NN+이/JJ
폄	펴/VB+ㅁ/EE
폈	펴/VB+었/EE|피/VB+었/EE
폈할	펴/VB+었/EE+하/VB+ㄹ/EE
평	편/NN
폰	포/NN+이/VB+ㄴ/EE
푸	풀/VB|프/VB+우/EE
푸세	풀/VB+시/EE+어/EE
푸셨	풀/VB+시/EE+었/EE
푸신	풀/VB+시/EE+ㄴ/EE
푸십	풀/VB+시/EE+ㅂ/EE
푼	풀/VB+ㄴ/EE|프/VB+ㄴ/EE
풀	푸/VB+ㄹ/EE
풂	풀/VB+ㅁ/EE
품	풀/VB+ㅁ/EE
풉	풀/VB+ㅂ/EE
풍	푸/VB+ᆼ/EE
픈	프/VB+ㄴ/EE
픈할	프/VB+ㄴ/EE+하/XV+ㄹ/EE
플	프/VB+ㄹ/EE
플텐	프/VB+ㄹ/EE+터/NN+이/VB+ㄴ/EE
픔	프/VB+ㅁ/EE
픔임	프/VB+ㅁ/EE+이/VB+ㅁ/EE
픕	프/VB+ㅂ/EE
픠	c/SL
핀	펴/VB+ㄴ/EE|피/NN+이/VB+ㄴ/EE|피/VB+ㄴ/EE
필	피/NN+ㄹ/JJ|피/VB+ㄹ/EE|피/NN+이/VB+ㄹ/EE
핌	피/VB+ㅁ/EE
핍	피/VB+ㅂ/EE
하	이/VB+라/JJ|하/NN
하여	해/VB
하여본	해보/VB+ㄴ/EE
한	하/VB+ㄴ/EE|하/NN+이/VB+ㄴ/EE|하/XV+ㄴ/EE
한갈	하/XV+ㄴ/EE+가/EE+ㄹ/JJ
한건	하/XV+ㄴ/EE+것/NN+이/VB+ㄴ/EE|하/XV+ㄴ/EE+것/NN+ㄴ/JJ|하/VB+ㄴ/EE+것/NN+이/VB+ㄴ/EE|하/VB+ㄴ/EE+것/NN+ㄴ/JJ
한걸	하/VB+ㄴ/EE+것/NN+ㄹ/JJ|하/XV+ㄴ/EE+것/NN+ㄹ/JJ
한게	하/VB+ㄴ/EE+것/NN+이/JJ|하/XV+ㄴ/EE+거/NN+이/JJ|하/XV+ㄴ/EE+것/NN+이/JJ
한기	하/VB+ㄴ/EE+것/NN+이/VB
한다와	하/VB+ㄴ다/EE+와/JJ|하/XV+ㄴ다/EE+와/JJ
한난	하/XV+ㄴ/EE+나/VB+ㄴ/EE
한내	하/XV+ㄴ/EE+나/NN+의/JJ
한는	하/VB+ㄴ/EE+늘/VB+ㄴ/EE
한단	하/XV+ㄴ/EE+다/JJ+ㄴ/JJ|하/XV+ㄴ/EE+다/EE+ㄴ/JJ|하/VB+ㄴ/EE+다/EE+는/EE
한달	하/XV+ㄴ/EE+다/EE+ㄹ/EE
한댔	하/VB+ㄴ/EE+다/EE+하/VB+았/EE
한댔잖	하/VB+ㄴ/EE+다/EE+하/VB+았/EE+지/EE+않/VB|하/XV+ㄴ/EE+다/EE+하/VB+았/EE+지/EE+않/VB
한로운	하/XV+ㄴ/EE+롭/VB+ㄴ/EE
한봐	하/XV+ㄴ/EE+보/VB+아/EE|하/VB+ㄴ/EE+보/VB+아/EE
한산	하/XV+ㄴ/EE+살/VB+ㄴ/EE
한신	하/XV+ㄴ/EE+시/EE+ㄴ/EE
한여	하/XV+ㄴ/EE+아/EE
한였	하/XV+ㄴ/EE+이/VB+었/EE|하/XV+ㄴ/EE+았/EE|하/VB+ㄴ/EE+았/EE
한예	하/VB+ㄴ/EE+이/VB+에/EE
한요	하/XV+ㄴ/EE+이/VB+오/EE
한을	하/VB+ㄴ/EE
한인	하/XV+ㄴ/EE+이/VB+ㄴ/EE+이/VB|하/XV+ㄴ/EE+이/VB+ㄴ/EE|하/VB+ㄴ/EE+이/VB+ㄴ/EE
한입	하/VB+ㄴ/EE+이/VB+ㅂ/EE
한쳐	하/VB+ㄴ/EE+치/VB+어/EE
한한	하/XV+ㄴ/EE+하/VB+ㄴ/EE|하/VB+ㄴ/EE+하/XV+ㄴ/EE|하/VB+ㄴ/EE+하/VB+ㄴ/EE|하/XV+ㄴ/EE+하/XV+ㄴ/EE
한할	하/VB+ㄴ/EE+하/VB+ㄹ/EE
한함	하/XV+ㄴ/EE+하/VB+ㅁ/EE
한해	하/XV+ㄴ/EE+하/VB+아/EE|하/VB+ㄴ/EE+하/VB+아/EE
한했	하/XV+ㄴ/EE+하/VB+았/EE
할	하/NN+ㄹ/JJ|하/VB+ㄹ/EE|하/XV+ㄹ/EE
할거	하/XV+ㄹ/EE+것/NN+이/VB
할거예	하/XV+ㄹ/EE+것/NN+이/VB+에/EE
할건	하/VB+ㄹ/EE+것/NN+이/VB+ㄴ/EE|하/VB+ㄹ/EE+거/NN+이/VB+ㄴ/EE
할겁	하/VB+ㄹ/EE+것/NN+이/VB+ㅂ/EE
할것	하/XV+ㄹ/EE
할게	하/XV+ㄹ/EE+것/NN+이/JJ|하/VB+ㄹ/EE+것/NN+이/JJ|하/VB+ㄹ/EE+것/NN+이/VB
할곤	하/VB+ㄹ/EE+고/EE+ㄴ/JJ
할긴	하/XV+ㄹ/EE+기/NN+ㄴ/EE
할까	하/XV+ㄹ/EE
할깝	하/XV+ㄹ/EE+까/EE+ㅂ/EE|하/VB+ㄹ/EE+까/EE+이/VB+ㅂ/EE|하/XV+ㄹ/EE+까/EE+이/VB+ㅂ/EE
할꺼	하/VB+ㄹ/EE+거/NN+이/VB
할두	하/XV+ㄹ/EE
할땐	하/XV+ㄹ/EE+때/NN+ㄴ/JJ|하/VB+ㄹ/EE+때/NN+ㄴ/JJ
할락합	하/VB+ㄹ/EE+려/EE+고/EE+하/VB+ㅂ/EE
할래	하/XV+ㄹ/EE+라/EE
할봐	하/XV+ㄹ/EE+보/VB+아/EE|하/VB+ㄹ/EE+보/VB+아/EE
할순	하/XV+ㄴ/EE+수/NN+ㄴ/JJ
할였	하/XV+ㄹ/EE+이/VB+었/EE
할예	하/VB+ㄹ/EE+이/VB+에/EE
할이	하/XV+리/EE
할인	하/VB+ㄹ/EE+이/VB+ㄴ/EE
할진	하/XV+ㄹ/EE+지/EE+이/VB+ㄴ/EE|하/VB+ㄹ/EE+지/EE+이/VB+ㄴ/EE|하/VB+ㄹ/EE+지/EE+ㄴ/JJ
할진댄	하/XV+ㄹ/EE+지/EE+이/VB+ㄴ/EE+대/EE+ㄴ/JJ
할테	하/XV+ㄹ/EE+터/NN+이/VB|하/VB+ㄹ/EE+터/NN+이/VB
할텐	하/XV+ㄹ/EE+터/NN+이/VB+ㄴ/EE|아/EE+하/VB+ㄹ/EE+터/NN+이/VB+ㄴ/EE|하/VB+ㄹ/EE+터/NN+이/VB+ㄴ/EE
할한	하/XV+하/XV+ㄴ/EE|하/VB+ㄹ/EE+하/XV+ㄴ/EE|하/XV+ㄹ/EE+하/XV+ㄴ/EE|하/XV+ㄹ/EE+하/VB+ㄴ/EE
할할	하/VB+ㄹ/EE+하/VB+ㄹ/EE
할했	하/VB+ㄹ/EE+하/VB+았/EE|하/XV+ㄹ/EE+하/XV+았/EE|하/VB+ㄹ/EE+하/XV+았/EE
함	하/VB+ㅁ/EE|하/XV+ㅁ/EE|하/IC+ㅁ/EE
함곤	하/XV+ㅁ/EE+고/EE+ㄴ/JJ
함는	하/XV+ㅁ/EE+은/JJ
함단	하/XV+ㅁ/EE+다/JJ+ㄴ/JJ
함러움	하/XV+ㅁ/EE+럽/XV+ㅁ/EE
함엔	하/XV+ㅁ/EE+에/JJ+ㄴ/JJ
함여	하/XV+ㅁ/EE+이/VB+어/EE|하/VB+ㅁ/EE+아/EE|하/XV+ㅁ/EE+어/EE
함였	하/XV+ㅁ/EE+이/VB+었/EE
함인	하/XV+ㅁ/EE+이/VB+ㄴ/EE|하/XV+ㅁ/EE+이/VB+ㄴ/EE+이/VB|하/VB+ㅁ/EE+이/VB+ㄴ/EE
함일	하/VB+ㅁ/EE+이/VB+ㄹ/EE|하/XV+ㅁ/EE+이/VB+ㄹ/EE
함입	하/XV+ㅁ/EE+이/VB+ㅂ/EE|하/VB+ㅁ/EE+이/VB+ㅂ/EE
함한	하/XV+ㅁ/EE+하/VB+ㄴ/EE|하/VB+ㅁ/EE+하/XV+ㄴ/EE|하/VB+ㅁ/EE+하/VB+ㄴ/EE|하/XV+ㅁ/EE+하/XV+ㄴ/EE
함함	하/VB+ㅁ/EE+하/XV+ㅁ/EE|하/XV+ㅁ/EE+하/XV+ㅁ/EE
함했	하/VB+ㅁ/EE+하/VB+았/EE|하/XV+ㅁ/EE+하/VB+았/EE
함힘듬	하/XV+ㅁ/EE+히/VB+ㅁ/EE+들/VB+ㅁ/EE
합	이하/VB+ㅂ/EE|하/XV+ㅂ/EE|아/EE+하/VB+ㅂ/EE|하/VB+ㅂ/EE|하/VB+ㅂ/EE+이/VB|하/XV+이/VB+ㅂ/EE|ㄹ/EE+하/XV+ㅂ/EE|하/XV+ㅂ/EE+이/VB
합했	하/VB+ㅂ/EE+하/VB+았/EE
항	향/NN|하/XV+ㄴ/EE
해	하/VB+아/EE|하/XV+아/EE
해간	하/VB+아/EE+가/VB+ㄴ/EE|하/XV+아/EE+가/VB+ㄴ/EE
해갈	하/XV+아/EE+가/VB+ㄹ/EE|하/VB+아/EE+가/VB+ㄹ/EE
해감	하/XV+아/EE+가/VB+ㅁ/EE|하/VB+아/EE+가/VB+ㅁ/EE
해갑	하/VB+아/EE+가/VB+ㅂ/EE|하/XV+아/EE+가/VB+ㅂ/EE
해갔	하/VB+아/EE+가/VB+았/EE|하/XV+아/EE+가/VB+았/EE
해곤	하/XV+아/EE+고/EE+는/EE|하/VB+아/EE+이/VB+고/EE+ㄴ/JJ
해긴	하/XV+아/EE+기/EE+ㄴ/JJ|하/VB+아/EE+기/EE+ㄴ/JJ
해길	하/VB+아/EE+기/EE+를/JJ|하/VB+아/EE+기/EE+ㄹ/EE|하/VB+아/EE+기/EE+ㄹ/JJ|하/XV+아/EE+기/EE+ㄹ/JJ|하/VB+아/EE+기/VB+ㄹ/EE
해난	하/XV+아/EE+나/NN+ㄴ/JJ
해날	하/VB+아/EE+나/VB+ㄹ/EE
해낸	하/XV+아/EE+내/VB+ㄴ/EE|하/VB+아/EE+내/VB+ㄴ/EE
해낼	하/VB+아/EE+내/VB+ㄹ/EE|하/XV+아/EE+내/VB+ㄹ/EE
해냄	하/XV+아/EE+내/VB+ㅁ/EE
해냅	하/VB+아/EE+내/VB+ㅂ/EE|하/XV+아/EE+내/VB+ㅂ/EE
해냈	하/VB+아/EE+내/VB+었/EE|하/XV+아/EE+내/VB+었/EE
해냈여	하/XV+아/EE+내/VB+었/EE+어/EE
해녀	하/VB+아/EE+니/VB+어/EE
해녔	하니/VB+었/EE
해논	하/XV+아/EE+놓/VB+ㄴ/EE
해놔	하/XV+아/EE+놓/VB+아/EE|하/VB+아/EE+놓/VB+아/EE
해놨	하/VB+아/EE+놓/VB+았/EE|하/XV+아/EE+놓/VB+았/EE
해다	하/VB+아/EE+달/VB|하/XV+아/EE+달/VB
해단	하/XV+아/EE+이/VB+다/JJ+ㄴ/JJ
해댄	하/VB+아/EE+대/VB+ㄴ/EE|하/XV+아/EE+대/VB+ㄴ/EE
해댈	하/VB+아/EE+대/VB+ㄹ/EE|하/XV+아/EE+대/VB+ㄹ/EE
해댈봐	하/XV+아/EE+대/VB+ㄹ/EE+보/VB+아/EE
해댔	하/VB+아/EE+대/VB+었/EE
해돼	하/XV+아/EE+되/VB+어/EE
해된	하/VB+아/EE+되/VB+ㄴ/EE
해될	하/XV+아/EE+되/VB+ㄹ/EE|하/VB+아/EE+되/VB+ㄹ/EE
해둔	하/XV+아/EE+두/VB+ㄴ/EE|하/VB+아/EE+두/VB+ㄴ/EE
해둘	하/XV+아/EE+두/VB+ㄹ/EE|하/VB+아/EE+두/VB+ㄹ/EE
해둡	하/XV+아/EE+두/VB+ㅂ/EE|하/VB+아/EE+두/VB+ㅂ/EE
해둬	하/VB+아/EE+두/VB+어/EE|하/XV+아/EE+두/VB+어/EE
해둬얄	하/XV+아/EE+두/VB+어/EE+야/EE+하/VB+ㄹ/EE
해뒀	하/VB+아/EE+두/VB+었/EE|하/XV+아/EE+두/VB+었/EE
해드	하/VB+아/EE+들/VB
해들	하/VB+아/EE+듣/VB
해들린	하/VB+아/EE+드리/VB+ㄴ/EE
해랬	하/VB+아/EE+라/EE+하/XV+았/EE|하/VB+아/EE+라/EE+하/VB+았/EE
해러	하/VB+아/EE+르/VB+어/EE
해러운	하/VB+아/EE+럽/XV+ㄴ/EE
해럽	하/VB+아/EE+러/VB+ㅂ/EE
해렀	하/VB+아/EE+리/VB+었/EE
해려	하/VB+아/EE+리/VB+어/EE|하/XV+아/EE+리/VB+어/EE|하/VB+아/EE+리/VB+어/EE+하/VB|하/VB+아/EE+리/VB+어/EE+이/VB
해려선	하/VB+아/EE+리/VB+어/EE+서/EE+ㄴ/JJ
해렸	하/VB+아/EE+리/VB+었/EE|하/XV+아/EE+리/VB+었/EE
해린	하/VB+아/EE+리/VB+ㄴ/EE|하/XV+아/EE+리/VB+ㄴ/EE|하리/VB+ㄴ/EE
해릴	하/VB+아/EE+리/VB+ㄹ/EE|하/XV+아/EE+리/VB+ㄹ/EE
해림	하/XV+아/EE+리/VB+ㅁ/EE
해립	하/XV+아/EE+리/VB+ㅂ/EE|하/VB+아/EE+리/VB+ㅂ/EE
해마	하/VB+아/EE+말/VB|하/XV+아/EE+말/VB
해본	하/XV+아/EE+보/VB+ㄴ/EE|하/VB+아/EE+보/VB+ㄴ/EE
해볼	하/XV+아/EE+보/VB+ㄹ/EE|하/VB+아/EE+보/VB+ㄹ/EE
해볼테	하/VB+아/EE+보/VB+ㄹ/EE+터/NN+이/VB
해봄	하/XV+아/EE+보/VB+ㅁ/EE|하/VB+아/EE+보/VB+ㅁ/EE
해봄한	하/VB+아/EE+보/VB+ㅁ/EE+하/VB+ㄴ/EE|하/XV+아/EE+보/VB+ㅁ/EE+하/XV+ㄴ/EE|하/XV+아/EE+보/VB+ㅁ/EE+하/VB+ㄴ/EE
해봄했	하/XV+아/EE+보/VB+ㅁ/EE+하/XV+았/EE
해봅	하/XV+아/EE+보/VB+ㅂ/EE|하/XV+아/EE+보/VB+ㅂ/EE+이/VB|하/VB+아/EE+보/VB+ㅂ/EE
해봐	하/VB+아/EE+보/VB+아/EE+하/VB|하/XV+아/EE+보/VB+아/EE+이/VB|하/VB+아/EE+보/VB+아/EE|하/XV+아/EE+보/VB+아/EE+하/VB|하/XV+아/EE+보/VB+아/EE|하/VB+아/EE+보/VB+아/EE+이/VB
해봤	하/XV+아/EE+보/VB+았/EE|하/VB+아/EE+보/VB+았/EE
해봤댔	하/VB+아/EE+보/VB+았/EE+다/EE+하/VB+았/EE
해봤한	하/VB+아/EE+보/VB+았/EE+하/XV+ㄴ/EE
해뵈	하/XV+아/EE+보이/VB
해부러	하불/VB+어/EE
해부렀	하/VB+아/EE+불/VB+었/EE
해분	하/VB+아/EE+불/VB+ㄴ/EE
해선	하/XV+아/EE+설/VB+ㄴ/EE|하/XV+아/EE+서/EE+ㄴ/JJ|하/VB+아/EE+서/EE+ㄴ/EE|하/XV+아/EE+서/EE+이/VB+ㄴ/EE|하/VB+아/EE+서/EE+이/VB+ㄴ/EE|하/VB+아/EE+서/EE+ㄴ/JJ
해섭	하/VB+아/EE+서/EE+이/VB+ㅂ/EE
해섰	하/XV+아/EE+서/VB+었/EE
해세	아/EE+하/VB+시/EE+어/EE|하/VB+아/EE+시/EE+어/EE+이/VB|하/XV+아/EE+시/EE+어/EE|하/VB+아/EE+시/EE+어/EE|하/XV+시/EE+어/EE
해셔	하/XV+아/EE+시/EE+어/EE|하/VB+아/EE+시/EE+어/EE|하/VB+아/EE+시/EE+어/EE+하/VB
해셨	아/EE+하/VB+시/EE+었/EE|하/XV+아/EE+시/EE+었/EE|하/VB+아/EE+시/EE+었/EE
해신	하/VB+아/EE+시/EE+ㄴ/EE|하/XV+아/EE+시/EE+ㄴ/EE
해실	하/VB+아/EE+시/EE+ㄹ/EE|하/XV+아/EE+시/EE+ㄹ/EE|아/EE+하/VB+시/EE+ㄹ/EE
해십	하/VB+아/EE+시/EE+ㅂ/EE+이/VB|하/VB+아/EE+시/EE+ㅂ/EE|하/XV+아/EE+시/EE+ㅂ/EE
해싸	하/VB+아/EE+쌓/VB+아/EE
해쌌	하/VB+아/EE+쌓/VB|하/VB+아/EE+싸/VB+았/EE
해얄	하/VB+아/EE+야/EE+하/VB+ㄹ/EE
해엔	하/XV+아/EE+에/EE+ㄴ/JJ|하/VB+아/EE+에/JJ+ㄴ/JJ
해여	하/VB+아/EE+이/VB+어/EE|하/XV+아/EE+이/VB+어/EE
해였	하/XV+아/EE+이/VB+었/EE|아/EE+하/VB+았/EE|하/VB+아/EE+이/VB+었/EE|하/XV+아/EE+었/EE|하/VB+아/EE+었/EE|하/VB+아/EE+아/EE+이/VB+었/EE
해온	하/VB+아/EE+오/VB+ㄴ/EE|하/XV+아/EE+오/VB+ㄴ/EE
해올	하/VB+아/EE+오/VB+ㄹ/EE|하/XV+아/EE+오/VB+ㄹ/EE
해옴	하/VB+아/EE+오/VB+ㅁ/EE|하/XV+아/EE+오/VB+ㅁ/EE
해옵	하/XV+아/EE+오/VB+ㅂ/EE|하/VB+아/EE+오/VB+ㅂ/EE
해와	하/VB+아/EE+오/VB+아/EE|하/XV+아/EE+오/VB+아/EE
해와봐	하/VB+아/EE+보/VB+아/EE
해왔	하/VB+아/EE+오/VB+았/EE|하/XV+아/EE+오/VB+았/EE
해요	하/VB+아/EE+이/VB+오/EE|하/XV+아/EE+이/VB+오/EE|하/VB+아/EE+오/EE|하/XV+아/EE+도/EE
해워둠	하/VB+아/EE+우/VB+어/EE+두/VB+ㅁ/EE
해인	하/XV+아/EE+이/VB+ㄴ/EE|하/VB+아/EE+이/VB+ㄴ/EE
해일	하/VB+아/EE+이/VB+ㄹ/EE|하/XV+아/EE+이/VB+ㄹ/EE
해임	하/XV+아/EE+ㅁ/EE
해입	하/VB+아/EE+이/VB+ㅂ/EE
해잖	하/VB+아/EE+지/EE+않/VB|아/EE+하/VB+지/EE+않/VB|하/XV+아/EE+지/EE+않/VB
해저	하/VB+아/EE+지/VB+어/EE
해져	ㄹ/EE+하/XV+아/EE+지/VB+어/EE|하/VB+아/EE+지/VB+어/EE|하/XV+아/EE+지/VB+어/EE|하/XV+아/EE+지/VB+어/EE+하/VB|하/VB+아/EE+지/VB+어/EE+어/EE
해져간	하/XV+아/EE+지/VB+어/EE+가/VB+ㄴ/EE|하/VB+아/EE+지/VB+어/EE+가/VB+ㄴ/EE
해져갈	하/XV+아/EE+지/VB+어/EE+가/VB+ㄹ/EE
해져갔	하/XV+아/EE+지/VB+어/EE+가/VB+았/EE|하/XV+지/VB+어/EE+가/VB+았/EE|하/VB+아/EE+지/VB+어/EE+가/VB+았/EE
해져려	하/XV+아/EE+지/VB+어/EE+리/VB+어/EE
해져렸	하/XV+아/EE+지/VB+어/EE+리/VB+었/EE
해져린	하/XV+아/EE+지/VB+어/EE+리/VB+ㄴ/EE|하/VB+아/EE+지/VB+어/EE+리/VB+ㄴ/EE
해져봐	하/VB+아/EE+지/VB+어/EE+보/VB+아/EE
해져선	하/VB+아/EE+지/VB+어/EE+서/EE+ㄴ/JJ
해져였	하/XV+아/EE+지/VB+어/EE+이/VB+었/EE
해져온	하/VB+아/EE+지/VB+어/EE+오/VB+ㄴ/EE
해져옴	하/XV+아/EE+지/VB+어/EE+오/VB+ㅁ/EE
해져와	하/VB+아/EE+지/VB+어/EE+오/VB+아/EE
해져왔	하/VB+아/EE+지/VB+어/EE+오/VB+았/EE|하/XV+아/EE+지/VB+어/EE+오/VB+았/EE
해졌	하/XV+아/EE+지/VB+었/EE|하/VB+아/EE+지/VB+었/EE|하/XV+아/EE+지/VB+었/EE+이/VB
해졌인	하/VB+아/EE+지/VB+었/EE+이/VB+ㄴ/EE
해준	하/VB+아/EE+주/VB+ㄴ/EE|하/XV+아/EE+주/VB+ㄴ/EE|하주/VB+ㄴ/EE
해준단	하/VB+아/EE+주/VB+ㄴ/EE+다/EE+ㄴ/JJ
해줄	하/XV+아/EE+주/VB+ㄹ/EE|하/VB+아/EE+주/VB+ㄹ/EE|하/VB+아/EE+주/VB|하/VB+아/EE+주/VB+ㄹ/EE+이/VB
해줄테	하/XV+아/EE+주/VB+ㄹ/EE+터/NN+이/VB
해줌	하/XV+아/EE+주/VB+ㅁ/EE|하/VB+아/EE+주/VB+ㅁ/EE
해줍	하/XV+아/EE+주/VB+ㅂ/EE|하/VB+아/EE+주/VB+ㅂ/EE
해줘	하/VB+아/EE+주/VB+어/EE+하/VB|하/VB+아/EE+주/VB+어/EE|하/XV+아/EE+주/VB+어/EE
해줘곤	하/VB+아/EE+주/VB+어/EE+고/JJ+ㄴ/JJ
해줘봤	하/VB+아/EE+주/VB+어/EE+보/VB+았/EE|하/XV+아/EE+주/VB+어/EE+보/VB+았/EE
해줬	하/XV+아/EE+주/VB+었/EE|하/VB+아/EE+주/VB+었/EE
해줬요	하/VB+아/EE+주/VB+었/EE+이/VB+오/EE
해줬잖	하/VB+아/EE+주/VB+었/EE+지/EE+않/VB|하/XV+아/EE+주/VB+었/EE+지/EE+않/VB
해지	하/VB+아/EE
해진	하/XV+하/XV+아/EE+지/VB+ㄴ/EE|하/XV+아/EE+지/EE+ㄴ/JJ|하/VB+아/EE+지/EE+ㄴ/JJ|하/XV+아/EE+지/VB+ㄴ/EE|하/VB+아/EE+지/VB+ㄴ/EE
해진해	하/VB+아/EE+지/VB+ㄴ/EE+하/VB+아/EE
해질	하/XV+아/EE+지/EE+ㄹ/JJ|하/XV+아/EE+ㄹ/EE+지/EE|하/XV+아/EE+지/VB+ㄹ/EE|하/XV+아/EE+지/VB+ㄹ/EE+이/VB|하/XV+ㄹ/EE|하/VB+아/EE+지/VB+ㄹ/EE|하/VB+아/EE+지/EE+ㄹ/JJ|하/VB+아/EE+ㄹ/EE+지/EE
해질봐	하/VB+아/EE+지/VB+ㄹ/EE+보/VB+아/EE|하/XV+아/EE+지/VB+ㄹ/EE+보/VB+아/EE
해짐	하/XV+아/EE+지/VB+ㅁ/EE|하/VB+아/EE+지/VB+ㅁ/EE
해집	하/VB+아/EE+지/VB+ㅂ/EE|하/XV+아/EE+지/VB+ㅂ/EE
해한	하/VB+아/EE+하/VB+ㄴ/EE|하/XV+아/EE+하/VB+ㄴ/EE|하/XV+아/EE+하/XV+ㄴ/EE
해할	하/VB+아/EE+하/VB+ㄹ/EE|하/XV+아/EE+하/VB+ㄹ/EE
해할봐	하/XV+아/EE+하/VB+ㄹ/EE+보/VB+아/EE
해할지	하/VB+아/EE+하/VB
해함	하/XV+아/EE+하/VB+ㅁ/EE|하/VB+아/EE+하/VB+ㅁ/EE
해합	하/XV+아/EE+하/VB+ㅂ/EE|하/VB+아/EE+하/VB+ㅂ/EE
해해	하/VB+아/EE+하/VB+아/EE|하/XV+아/EE+하/XV+아/EE|하/XV+아/EE+하/VB+아/EE
해했	하/VB+아/EE+하/VB+았/EE|하/XV+아/EE+하/VB+았/EE
핸	해/NN+ㄴ/JJ|해/NN+이/VB+ㄴ/EE
핼	해/NN+ㄹ/JJ
햅	해/NN+이/VB+ㅂ/EE
햇	하/VB+았/EE|해/NN|하/XV+았/EE|하/XV+앗/EE
햇따	하/XV+앗/EE+다/EE
했	하/VB+았/EE|하/XV+았/EE
했간	하/XV+았/EE+가/EE+ㄴ/JJ|하/VB+았/EE+가/EE+ㄴ/JJ
했건	하/XV+았/EE+것/NN+ㄴ/JJ
했게	하/XV+았/EE+것/NN+이/JJ
했곤	하/VB+았/EE+고/EE+ㄴ/JJ
했깐	하/VB+았/EE+까/EE+ㄴ/JJ
했난	하/XV+았/EE+나/NN+ㄴ/JJ
했단	하/VB+았/EE+다/JJ+ㄴ/JJ
했댔	하/VB+았/EE+대/VB+었/EE
했땐	하/XV+았/EE+때/NN+이/VB+ㄴ/EE
했랬	하/XV+았/EE+라/EE+하/VB+았/EE|하/VB+았/EE+라/EE+하/VB+았/EE
했런	하/VB+았/EE+러/VB+ㄴ/EE
했만	하/XV+았/EE+말/VB+ㄴ/EE
했본	하/VB+았/EE+보/VB+ㄴ/EE
했봐	하/XV+았/EE+보/VB+아/EE|하/VB+았/EE+보/VB+아/EE
했세	하/XV+았/EE+시/EE+어/EE|하/VB+았/EE+시/EE+어/EE
했야	하/VB+았/EE+이/VB+아/EE
했었	하/XV+았/EE
했여	하/VB+았/EE+아/EE
했였	하/VB+았/EE+았/EE
했요	하/XV+았/EE+오/EE
했으	하/VB+았/EE+을/EE
했인	하/VB+았/EE+이/VB+ㄴ/EE|하/XV+았/EE+이/VB+ㄴ/EE
했잖	하/XV+았/EE+지/EE+않/VB|하/VB+았/EE+지/EE+않/VB
했졌	하/XV+아/EE+지/VB+었/EE
했진	하/VB+았/EE+지/EE+ㄴ/JJ
했테	하/VB+았/EE+터/NN+이/VB
했텐	하/XV+았/EE+터/NN+이/VB+ㄴ/EE|하/VB+았/EE+터/NN+이/VB+ㄴ/EE
했한	하/VB+았/EE+하/XV+ㄴ/EE|하/XV+았/EE+하/VB+ㄴ/EE|하/VB+았/EE+하/VB+ㄴ/EE|하/XV+았/EE+하/XV+ㄴ/EE
했함	하/XV+았/EE+하/VB+ㅁ/EE
했합	하/XV+았/EE+하/VB+ㅂ/EE
했해	하/VB+았/EE+하/VB+아/EE|하/XV+았/EE+하/VB+아/EE
했했	하/XV+았/EE+하/VB+았/EE|하/XV+았/EE+하/XV+았/EE
햐여	하/VB+아/EE
헀	하/VB+았/EE
허	하/VB|헐/VB|하/XV
헌	하/VB+ㄴ/EE|허/VB+ㄴ/EE|헐/VB+ㄴ/EE|허/XV+ㄴ/EE|하/XV+ㄴ/EE|허/VB+ㄴ/EE+이/VB+라/EE
헌인	허/VB+ㄴ/EE+이/VB+ㄴ/EE
헌티	한/JJ+테/JJ
헐	허/XV+ㄹ/EE|허/VB+ㄹ/EE|허/NN+ㄹ/JJ|하/XV+ㄹ/EE|허/VB+ㄹ/JJ|허/XV+ㄹ/JJ|허/VB+ㄹ/EE+이/VB
헐쳐	허/VB+ㄹ/EE+치/NN+이/VB+어/EE
험	허/XV+ㅁ/EE|강/NN|허/VB+ㅁ/EE
헙	험/NN|허/VB+ㅂ/EE|허/XV+ㅂ/EE
헜	허/XV+었/EE|허/VB+었/EE
헝	허/XV+ᆼ/EE
헤	하/XV+아/EE|허/XV+어/EE|히/VB+어/EE|허/VB+아/EE|하/VB+아/EE|혜/NN|해/VB
헤갔	하/XV+아/EE+가/VB+았/EE
헤길	하/VB+아/EE+기/EE+ㄹ/JJ
헤뒀	하/XV+아/EE+두/VB+었/EE
헤렸	하/VB+아/EE+리/VB+었/EE
헤볼	해보/VB+ㄹ/EE
헤봐	허/XV+어/EE+보/VB+아/EE|하/XV+아/EE+보/VB+아/EE|해보/VB+아/EE
헤봤	해보/VB+았/EE
헤세	하/XV+아/EE+시/EE+어/EE
헤얄	하/VB+아/EE+야/EE+하/VB+ㄹ/EE
헤준	하/XV+아/EE+주/VB+ㄴ/EE|하/VB+아/EE+주/VB+ㄴ/EE
헤줄	하/XV+아/EE+주/VB+ㄹ/EE|하/VB+아/EE+주/VB+ㄹ/EE
헤줍	하/VB+아/EE+주/VB+ㅂ/EE
헤줘	하/VB+아/EE+주/VB+어/EE
헤줬텐	하/XV+아/EE+주/VB+었/EE+터/NN+이/VB+ㄴ/EE
헷	허/VB+었/EE
헸	허/VB+었/EE|허/XV+었/EE|하/VB+았/EE|하/XV+었/EE|하/XV+았/EE|허/VB+았/EE
헸간	허/VB+었/EE+가/EE+ㄴ/JJ
헸잖	허/VB+었/EE+지/EE+않/VB|하/XV+았/EE+지/EE+않/VB|하/VB+았/EE+지/EE+않/VB|허/XV+었/EE+지/EE+않/VB
헹한	행/NN+하/XV+ㄴ/EE
혀	히/VB+어/EE|허/XV+어/EE|허/VB+아/EE
혀간	히/VB+어/EE+가/VB+ㄴ/EE
혀갈	히/VB+어/EE+가/VB+ㄹ/EE
혀갔	히/VB+어/EE+가/VB+았/EE
혀길	히/VB+어/EE+기/EE+ㄹ/JJ|히/VB+어/EE+기/EE+를/JJ
혀낸	히/VB+어/EE+내/VB+ㄴ/EE
혀낼	히/VB+어/EE+내/VB+ㄹ/EE
혀냈	히/VB+어/EE+내/VB+었/EE
혀논	히/VB+어/EE+놓/VB+ㄴ/EE
혀놨	히/VB+어/EE+놓/VB+았/EE
혀다	히/VB+어/EE+달/VB
혀둔	히/VB+어/EE+두/VB+ㄴ/EE
혀둘	히/VB+어/EE+두/VB+ㄹ/EE
혀뒀	히/VB+어/EE+두/VB+었/EE
혀드	히/VB+어/EE+들/VB
혀든	히/VB+어/EE+들/VB+ㄴ/EE
혀려	히/VB+어/EE+리/VB+어/EE
혀렸	히/VB+어/EE+리/VB+었/EE
혀린	히/VB+어/EE+리/VB+ㄴ/EE|아/EE+히/VB+어/EE+리/VB+ㄴ/EE
혀릴	히/VB+어/EE+리/VB+ㄹ/EE
혀림	히/VB+어/EE+리/VB+ㅁ/EE
혀립	히/VB+어/EE+리/VB+ㅂ/EE
혀먼	히/VB+어/EE+멀/VB+ㄴ/EE
혀본	히/VB+어/EE+보/VB+ㄴ/EE
혀볼	히/VB+어/EE+보/VB+ㄹ/EE
혀봐	히/VB+어/EE+보/VB+아/EE|하/XV+아/EE+보/VB+아/EE
혀봤	히/VB+어/EE+보/VB+았/EE
혀선	히/VB+어/EE+서/EE+ㄴ/JJ
혀설	히/VB+어/EE+서/EE+ㄹ/JJ
혀셨	히/VB+어/EE+시/EE+었/EE
혀였	히/VB+어/EE+이/VB+었/EE
혀온	히/VB+어/EE+오/VB+ㄴ/EE
혀올	히/VB+어/EE+오/VB+ㄹ/EE
혀옴	히/VB+어/EE+오/VB+ㅁ/EE
혀와	히/VB+어/EE+오/VB+아/EE
혀왔	히/VB+어/EE+오/VB+았/EE
혀잖	허/XV+어/EE+지/EE+않/VB
혀져	히/VB+어/EE+지/VB+어/EE
혀져간	히/VB+어/EE+지/VB+어/EE+가/VB+ㄴ/EE
혀져갔	히/VB+어/EE+지/VB+어/EE+가/VB+았/EE
혀져온	히/VB+어/EE+지/VB+어/EE+오/VB+ㄴ/EE
혀졌	히/VB+어/EE+지/VB+었/EE|히/VB+어/EE+었/EE+지/EE
혀준	히/VB+어/EE+주/VB+ㄴ/EE
혀줄	히/VB+어/EE+주/VB+ㄹ/EE
혀줌	히/VB+어/EE+주/VB+ㅁ/EE
혀줘	히/VB+어/EE+주/VB+어/EE
혀줬	히/VB+어/EE+주/VB+었/EE
혀진	히/VB+어/EE+지/EE+ㄴ/JJ|허/XV+어/EE+지/VB+ㄴ/EE|히/VB+어/EE+지/VB+ㄴ/EE
혀질	히/VB+어/EE+ㄹ/EE+지/EE|히/VB+어/EE+지/EE+ㄹ/JJ|하/XV+아/EE+지/VB+ㄹ/EE|히/VB+어/EE+ㄹ/EE|히/VB+어/EE+지/VB+ㄹ/EE
혀질봐	히/VB+어/EE+지/VB+ㄹ/EE+보/VB+아/EE
혀질텐	히/VB+어/EE+지/VB+ㄹ/EE+터/NN+이/VB+ㄴ/EE
혀짐	히/VB+어/EE+지/VB+ㅁ/EE
혀집	히/VB+어/EE+지/VB+ㅂ/EE
혀했	히/VB+어/EE+하/VB+았/EE
혀혀	허/VB+어/EE+허/VB+어/EE
혁	형/NN+이/VB
혔	하/VB+었/EE|혀/VB+었/EE|허/XV+었/EE|하/VB+았/EE|하/XV+었/EE|히/VB+었/EE|허/VB+었/EE
혔잖	히/VB+었/EE+지/EE+않/VB
혔해	히/VB+었/EE+하/VB+아/EE
형	햄/NN
혠	혜/NN+ㄴ/JJ
혤	혜/NN+ㄹ/JJ
혼	호/NN+이/VB+ㄴ/EE
홉	호/NN+이/VB+ㅂ/EE
화	학/NN|와/NN|호/NN
환	화/NN+이/VB+ㄴ/EE|화/NN+ㄴ/JJ
활	화/NN+ㄹ/JJ
활했	화/NN+ㄹ/JJ+하/VB+았/EE
황	화/NN
황한	항/NN+하/XV+ㄴ/EE
회인	획/NN+이/VB+ㄴ/EE
횐	회/NN+ㄴ/JJ|회/NN+이/VB+ㄴ/EE|흰/NN
횝	회/NN+이/VB+ㅂ/EE
횟	회/NN
후	우/NN
후차	훛/VB+아/EE
훈	후/NN+ㄴ/JJ
훓	훑/VB
훙	흥/NN
휜	휘/VB+ㄴ/EE
휠	휘/VB+ㄹ/EE
휩	휘/VB+ㅂ/EE
흘러	흐르/VB+어/EE|흐르/VB+어/EE+아/EE
흘러간	흐르/VB+어/EE+가/VB+ㄴ/EE
흘러갈	흐르/VB+어/EE+가/VB+ㄹ/EE
흘러감	흐르/VB+어/EE+가/VB+ㅁ/EE
흘러갔	흐르/VB+어/EE+가/VB+았/EE
흘러갔간	흐르/VB+어/EE+가/VB+았/EE+가/EE+ㄴ/JJ
흘러난	흐르/VB+어/EE+나/VB+ㄴ/EE
흘러낸	흐르/VB+어/EE+내/VB+ㄴ/EE
흘러닌	흐르/VB+어/EE+니/VB+ㄴ/EE
흘러드	흐르/VB+어/EE+들/VB
흘러려	흐르/VB+어/EE+리/VB+어/EE
흘러렸	흐르/VB+어/EE+리/VB+었/EE
흘러였	흐르/VB+어/EE+이/VB+었/EE
흘러온	흐르/VB+어/EE+오/VB+ㄴ/EE
흘러올	흐르/VB+어/EE+오/VB+ㄹ/EE
흘러와	흐르/VB+어/EE+오/VB+아/EE
흘러왔	흐르/VB+어/EE+오/VB+았/EE
흘러져	흐르/VB+어/EE+지/VB+어/EE
흘러졌	흐르/VB+어/EE+지/VB+었/EE
흘러쳤	흐르/VB+어/EE+치/VB+었/EE
흘러흘러	흐르/VB+어/EE+흐르/VB+어/EE
흘렀	흐르/VB+었/EE
희	회/NN
흰	희/NN+이/VB+ㄴ/EE|희/VB+ㄴ/EE|희/VB+ㄴ/EE+이/VB|희/NN+ㄴ/JJ
흴	희/NN+ㄹ/JJ|희/VB+ㄹ/EE
흽	희/NN+이/VB+ㅂ/EE
히	이/MA|혀/VB+어/EE|이/JJ|혀/VB
히감	혀가/VB+ㅁ/EE
힌	히/MA+ㄴ/JJ|히/VB+ㄴ/EE|아/EE+히/VB+ㄴ/EE
힌거	히/VB+ㄴ/EE+것/NN+이/VB
힐	히/VB+ㄹ/EE|히/VB+ㄹ/EE+이/VB|어/EE+히/VB+ㄹ/EE
힐게	히/VB+ㄹ/EE+거/NN+이/JJ
힐봐	히/VB+ㄹ/EE+보/VB+아/EE
힐요	히/VB+ㄹ/EE+이/VB+오/EE
힘	히/VB+ㅁ/EE
힘한	히/VB+ㅁ/EE+하/XV+ㄴ/EE
힙	히/VB+ㅂ/EE
힜	히/VB+었/EE
